NAME	GENDER	AGE	ADDRESS
Alicia Fuentes	F	48	Walton Street
Jo-Ting Losev	F	46	Hemenway Street
Elena Edmonds	F	58	Elmwood Avenue
Naydene Cabral	F	46	Winthrop Street
Dato Rosengren	M	22	Mystic Street
Fernanda Serrano	F	37	Redlands Road
Emiliano Wenk	M	90	Paulding Street
Larry Lapin	M	71	Atwill Road
Jakub Gondos	M	61	Mitchell Street
Derek Kazanin	M	55	Tennis Road
Jens Tuimalealiifano	M	83	Rockwood Street
Nikola Kadhi	M	75	Glenville Avenue
Takayuki Dundar	M	27	Cornelia Street
Njisane Arkhipova	M	73	Charles River Avenue
Rauli Schlanger	M	18	Dexter Street
Vera Frangilli	F	48	Hill Top Street
Marilyn Dominguez	F	43	Celia Road
Reza Scown	M	27	Southbound Frontage Road
Ahmed Sorokina	M	28	Long Avenue
Robert Marennikova	M	78	Parkson Street
Esthera Koschischek	F	23	Willowwood Street
Yunhee Hatsko	F	38	Leniston Street
Anna Choi	F	80	Maybury Street
Jingjing Gray	F	88	Anselm Terrace
Jaroslaw Kalina	M	65	Greenmount Place
Daniella Subschinski	F	65	Spring Valley Road
Jonathan Niit	M	38	Cazenove Street
Kelly Gemmell	F	24	Johnson Avenue
Todor Tong	M	72	Newhall Place
Hamish Drabenia	M	84	Cheshire Street
Petr Smith	M	64	Townsend Street
Hedvig Alameri	F	58	Tobin Bridge
Courtney Bischof	F	39	Sharp Street
Johannes Willis	M	56	Delore Circle
Zhaoxu Cordeiro	M	82	Haverhill Street
Aleks Pirghie	M	81	Campanella Way
Robert Ryan	M	16	Washburn Avenue
Zhizhi Kehoe	M	83	Ramsdell Avenue
Suyoung Savsek	M	16	Flavia Street
Aman Schulte	M	55	Kelley Circle
Bilel Inglis	M	36	Pond View Avenue
Amel Kim	M	48	Wayne Street
Beatriz Nooijer	F	36	Grove Square
Tumurkhuleg Hernandez	M	63	Commodore Terrace
Alexa Patrick	F	37	Trinity Place
Bartlomiej Marroquin	M	45	Hillcroft Road
Ryan Prasad	M	29	Eugenia Road
Maialen Uriarte	F	16	Ford Street
Boon Cortes	M	60	Woodward Park Street
Deniz Almazam	M	25	Eagle Square
Lok Poglajen	F	90	Farnham Street
Charline Chen	F	27	Traymore Street
Alexander Herrera	M	33	Holyoke Place
Jianbo Megannem	M	26	Westminster Avenue
Peter Ochoa	M	53	Tennis Road
Alberto Bauza	M	86	Waterhouse Street
Tanoh Mehari	F	39	Edgerly Place
Phillipp Al-Mashhadani	M	68	Lila Road
Mohanad Raudaschl	M	89	Croftland Avenue
Gemma Gaiduchik	F	89	Franklin Park Service Road
Adam Houssaye	M	56	Sunnyside Street
Mariko Shimamoto	F	52	Oswald Street
Krista Coci	F	44	Randlett Place
Alexey Perilli	M	90	Merrill Avenue
Akvile Saedeleer	F	65	Wall Street
Bernard Tamayo	M	24	Hillview Avenue
Trey Kirkham	M	83	Marmion Street
Chia-En Miley	F	53	Blaine Street
Vincent Girke	M	59	Brookford Street
Aselefech Gkountoulas	F	35	Grant Place
Mateusz Metu	M	20	Bradlee Court
Sebastien Halmuratov	M	32	Stevens Court
Marouen Tatari	M	80	Henderson Avenue
Btissam Brunstrom	F	74	Seaverns Avenue
Sinead Colle	F	48	Hillcroft Road
Aries Coston	M	31	Doone Avenue
Mariya Gibson	F	90	Plainfield Street
Marina Tchuanyo	F	19	Causeway Street
Anja Solar	F	60	Harleston Street
Remy Barac	M	77	Hart Place
Hannah Barker	F	69	Saybrook Street
Anne Fahden	F	68	Chesterton Street
Bertrand Nakamoto	M	40	Bodwell Street
Sidarka Smelyk	F	72	Wildwood Street
Pavel Lee	M	49	Lewis Place
Chieko Cheong	F	69	Larch Place
Petar Urantungalag	M	67	Coolidge Hill Road
Srdjan Stein	M	32	Sinclair Road
Lisa Kamaruddin	F	74	Keith Street
Stephanie Rodrigues	F	24	Callender Street
Nataliya Lippok	F	45	Grieco Terrace
Stefan Webster	M	77	Andria Road
Noel Samara	F	50	Vesta Road
Rachel Gonzalez	F	36	Dimock Street
Natalia Kitamoto	F	49	Saint John Street
Rasmus Quinchara	M	53	Wilcock Street
Sanah Ye	F	89	Penfield Street
Benjamin Pietrus	M	53	Margo Road
Burry Rodriguez	M	82	Saint Johns Road
Ivan Araujo	M	24	Myrtlebank Avenue
Silvana Bianconi	F	65	Cheshire Street
Andrea Tebulo	F	33	Bostonia Avenue
Bumyoung Soares	M	88	Shea Road
Antonin Morais	M	90	Lauriat Street
Kyoko Bennett	F	47	Wharton Court
Molly Shtokalov	F	66	Myles Standish Road
Clara Mason	F	66	Custom House Street
Helge Saladino	M	90	Tovar Street
Ara Hashim	M	63	Kovey Court
Hakim Nyantai	M	18	Exchange Place
Sergey Marco	M	59	Sammett Avenue
Hendrik Tetyukhin	M	31	Partridge Place
Mourad Nimke	M	70	Norumbega Street
Sergio Modos	M	30	Monmouth Street
Meiyu Iljustsenko	F	62	Mclellan Street
Ivana Monteiro	F	17	Woolsey Square
Kay Rosa	M	30	Newhall Place
Igor Cemberci	M	76	Border Street
Wei Zilberman	F	43	Chester Park
James Godelli	M	34	Waterhouse Street
Sven Nascimento	M	79	Bent Street
Samantha Ahamada	F	47	Bancroft Street
Vittoria Lima	F	55	Supple Road
Liviu Centrowitz	M	67	Purchase Street
Hye Wallace	M	64	Babe Ruth Park Drive
Johana Pistorius	F	80	Fisher Avenue
Kentaro Bar-Or	M	46	Smith Field Road
Jose Morgan	M	58	Wharf Street
Sophie Ahmadov	F	30	Rindge Avenue
Sergey Lacrabere	M	51	Ripley Road
Anna Menkov	F	68	Mozart Street
Marquise Mohaupt	M	60	Pleasant Avenue
Yevgeniy Gushchina	M	59	Old Landing Way
Anne-Sophie Gustavsson	F	51	Ryder Hill Road
Esther Robinson	F	88	Greenleaf Street
Lena Gasimov	F	59	Newbury Street
Samir Panguana	M	82	Trevore Street
Karen Jankunas	F	28	Rupert Street
Robin Vesely	M	45	Landor Road
Sung Ibanez	M	45	Coronado Road
Abdihakem Jongjit	M	54	Dwight Street
Ibrahima Louw	M	80	Gove Street
Richard Sarrapio	M	25	Roseland Street
Shara Gomez	F	72	Dana Avenue
Bianca Athanasiadis	F	36	Delos Street
Junjing Kang	F	39	Alkyris Road
Stanislav Cherobon-Bawcom	M	31	Iffley Road
Rita Bulatovic	F	51	School Street Place
Chi Kim	M	41	Beckler Avenue
Sergi Soto	M	70	Blanche Street
Yoon Kelsey	F	19	Loring Place
Beth Guo	F	65	Medway Street
Deron Estanguet	M	71	L Street
Shaunae Hallgrimsson	F	87	Hillview Avenue
Massimo Harradine	M	83	Robinwood Avenue
Lauren Janistyn	F	21	Rand Street
Gladys Mandell	F	35	Lockwood Street
Stefanos Lennon-Ford	M	21	Dunboy Street
Annette Engen	F	16	Burwell Road
Ryan Ovtcharov	M	24	Franklin Park Service Road
Teresa Kim	F	51	East Fifth Street
DeeDee Montoya	F	63	Fossdale Road
Da-Woon Morkov	F	54	Montague Street
Sergey Buckman	M	34	Shandon Road
Katinka Muramatsu	F	17	Earnshaw Street
Keigo Aguilar	M	16	Cambridgeside Place
Alessio Ariza	M	63	Melvin Avenue
Peter Gonzalez	M	74	Intervale Street
Kirani Kalargaris	M	53	Half Moon Street
Yaroslava Mehmedi	F	85	Woodley Avenue
Gia Mogawane	M	37	Trident Street
Salim Martinez	M	16	Martin Street
Alvaro Xu	M	77	Bolster Street
Freya Kalmer	F	67	Neponset Avenue
Kurt Tran-Swensen	M	82	Lomasney Way
Mutaz Pospisil	M	57	Baird Street
Nikolay Pota	M	32	Pama Gardens
Lieuwe Carney	M	36	Wellesmere Park
Mohamed Nystrand	M	56	Farwell Avenue
Margarita Donckers	F	24	Back Street
Ahmed Elkawiseh	M	18	Dunboy Street
Thais Pereira	F	84	Alcorn Street
Laszlo Cwalina	M	21	Presley Road
Ruggero Dong	M	16	Lombard Street
Mercy Nakamoto	F	58	Meridian Street
Uladzimir Bertrand	M	28	Dewey Street
Tsvetana Rogers	F	31	Napier Park
Omar Hurst	M	33	Arlington Avenue
Jake Im	M	56	Belle Avenue
Taoufik Geziry	M	33	Irwin Avenue
Jiaduo Calzada	F	69	Whitcomb Avenue
Imke Bosetti	F	22	Akron Place
Russell Miao	M	70	Wilkins Place
Ser-Od He	M	84	Humphreys Place
Christopher Gkolomeev	M	54	Soden Place
Stepan Gallantree	M	90	Garden Lane
Andrei Yazdani	M	78	Lee Street
Kacper Napo	M	77	Willet Street
Anabel Dominguez	F	67	Monument Avenue
Sergey Medhin	M	20	Newbern Street
Antonija Kim	F	56	Ryder Hill Road
Giovani Krug	M	42	Granada Avenue
Marcus Khalid	M	46	Islington Street
Won Teltull	M	42	Elmhurst Street
Nicholas Rosa	M	16	Butland Court
Amanda Ndlovu	F	65	Westbourne Street
Tassia Grotowski	F	60	Daniel Court
Alan Mestres	M	86	Pine Ridge Road
Yuhei Hybois	M	53	Riverbank Place
Mads Whitty	M	53	Mckenna Terrace
Mihai Correa	M	21	Eulita Terrace
Peter Neethling	M	42	Hillock Street
Lina Hassine	F	79	Rosewood Street
Stanislau Dmytrenko	M	71	Hewes Street
Stevy Fernandez	M	72	Cornell Street
Teodor Wilson	M	54	Armory Street
Damien Williams	M	42	Wave Avenue
Denis Rezola	M	24	Hart Place
Marcello Mendoza	M	32	Annavoy Street
Dmytro Xie	M	32	Townsend Street
Michael Matkowska	M	21	Chestnut Avenue
Lukasz Fitzgerald	M	75	Sun Court Street
DeeDee Warfe	F	24	Fairmont Avenue
Stsiapan Balmy	M	77	Blanchard Road
Fergus Sykorova	M	71	Beckler Avenue
Marina Ma	F	37	Varney Street
Carla Amaral	F	48	Marie Avenue
Marin Yun	M	38	Reddy Avenue
Aly Roberts	M	31	William Street
Mirco Pavoni	M	70	Vogel Street
Manu Boonwan	M	22	Water Street
Maximiliano Matsumoto	M	76	Clearwater Drive
Citra Comba	F	82	Montmorenci Avenue
Karim Kuczynski	M	73	Grayson Street
Maiko Zhang	F	53	Woodman Street
Ryan Welte	M	18	Charme Avenue
Craig Jaramillo	M	72	Saint Brendan Road
Mario Vanasch	M	49	Larchwood Drive
Felix Verbij	M	81	Stanley Street
Kenichi Palmarsson	M	83	Pleasant Hill Avenue
Jacques Smith	M	49	Cambridgepark Drive
Vardan Romeu	M	52	Tetlow Street
Vincenzo Moolman	M	81	Lebanon Street
Jerome Pikkarainen	M	84	Boxford Terrace
Brittany Terraza	F	55	Montello Street
Elena Kitum	F	20	Nixon Street
Roderick Nagai	M	42	Sun Court Street
Irene Kreisinger	F	63	Divinity Avenue
Bubmin Saenz	M	20	Rock Avenue
Elena Mekic	F	63	Larkhill Road
Hossam Franek	M	75	Dimock Street
Christopher Flood	M	41	Mariposa Street
Sebastian Gamera-Shmyrko	M	74	Caspian Way
Danijel Carriqueo	M	58	Atherstone Street
Konstadinos Voronov	M	59	Forbes Street
Darcy Zouari	F	65	Devine Way
Yuliya Wade-Fray	F	80	Donald Road
Zivko Manafov	M	43	Patten Street
Martin Lucie-Smith	M	29	Fowle Street
Sardar Rego	M	73	Boylston Place
Gia Yoon	M	72	Blackwell Street
Andrey Fokina-Semenova	M	31	Penhallow Street
Elisabeth Worthington	F	39	Laban Pratt Road
Iuliia Barseghyan	F	32	Bloomfield Street
Denys Hasannen	M	72	Jefferson Street
Andre Romeu	M	90	Knapp Street
Magalie Allen	F	69	Sudbury Street
Olga Richards	F	25	Hartford Court
Xuanxu Barnard	F	34	Penniman Road
Annabel Sun	F	26	Hart Place
Casey Mccabe	M	20	Peter Parley Road
Joseph Nielsen	M	46	Storey Place
Alice Liu	F	65	Tanglewood Road
Nathan Barnhart	M	64	Mcgreevey Way
Patrick Navarro	M	51	Brookvale Street
Elena Zhang	F	29	Messinger Street
Dmitrii Edoa	M	46	Wingate Road
Michael Mirnyi	M	88	Wesley Place
Adam Jezierski	M	37	Inman Court
Valentino Ferguson-McKenzie	M	65	Pine Lodge Road
Helalia Mclean	F	60	Michigan Avenue
Agnieszka Skhirtladze	F	56	Yeoman Street
Jieun Sukhorukov	F	56	Elizabeth Street
Selim Karagoz	M	87	Rockview Place
Melissa Brguljan	F	84	Atwood Road
Moon Reed	M	88	Bluefield Terrace
Marvin Rice	M	90	Walden Park
Alysia Tirode	F	46	Crispus Attucks Place
Vincent Jagar	M	47	Mackin Street
Victoria Dasdelen	F	39	Blakeslee Street
Malek Tomicevic	M	84	Emmet Street
Yerkebulan Hooper	M	78	Rawson Street
Fabiana Saka	F	34	Stinson Court
Gael Mushkiyev	M	90	Eatonia Street
Tim Bernado	M	48	Thane Street
Susana Barcelo	F	48	Kingsland Street
Irene Russell	F	73	Blandford Street
Thorbjorn Demps	M	61	Oakley Street
Laurence Zyabkina	M	19	Joyce Road
Reika Moretti	F	32	University Road
Keith Pavoni	M	69	Lebanon Street
Anthony Zhyharau	M	28	Rumford Road
Darrel Yamane	M	22	Langford Park
Tontowi Benedetti	M	55	Cranston Street
Errol Benes	M	34	Lovell Street
Todd Kuzmenok	M	61	Magazine Court
Yasemin Cavela	F	63	Burnside Avenue
Xin Reis	F	51	High View Avenue
Nur Forbes	F	23	Marmion Street
Martin Murray	M	60	Lynde Street
Begona Hepburn	F	88	Tyndale Street
Emma Buckman	F	41	Charles Park Road
Victoria Salopek	F	88	Irma Street
Wei Lepke	M	52	Glendale Street
Carlos Mellouli	M	42	Rugdale Road
Roline Camilo	F	70	Carlford Road
Yassine Bazzoni	M	40	Garner Road
Christin Brown	F	86	Rawson Street
Yohan Miljanic	M	77	Fairlane Road
Nils Pascual	M	83	Guernsey Street
Ewelina Safronov	F	51	Harrow Street
Luke Ruh	M	31	Village Court
William Zhang	M	30	Solaris Road
Aida Felix	F	54	Linwood Square
Alexandr Cao	M	77	Brenton Street
Tomas Kaki	M	40	Second New Way
Pauline Ayim	F	86	Rogers Park Avenue
Mathias Laukkanen	M	67	Morey Road
Niklas Capelli	M	40	Bickford Avenue
Johan Arvaniti	M	54	Gardenside Street
Eddermys Djokovic	M	28	Woodledge Street
Anas Ma	M	38	Auburn Street
Soumiya Hykes	F	52	Milwood Street
Dmytro Merrien	M	51	Athelwold Road
Dante Ma	M	67	Gilmer Street
Anna Hosking	F	64	Farragut Road
Roland Lapi	M	63	Proctor Street
Astrida Musgrove	F	40	Chandler Street
Xiaoxia Yamagata	F	86	Rosseter Street
Hichem Schwarz	M	88	Stoughton Street
Muhamad Idowu	M	87	Mapleton Street
Ingrid Fogarty	F	57	Bruce Street
Ons Buljubasic	F	86	Chalk Street
Spyridon Zhou	M	29	Allens Alley
Melissa Glynn	F	36	Bernard Street
Jan-Di Resch	F	60	Tilesboro Street
Elia Mota	M	80	Woodward Park Street
Alexander Sundstedt	M	29	Bolton Street
Wissem Davies	M	56	Langdon Street
Pui Coronel	F	46	Elm Street
Renata Rasic	F	86	Hancock Park
Ning Chen	F	32	Ansonia Road
Dmytro Arms	M	60	Saint John Street
Josiane Miyake	F	73	Faywood Avenue
Mel Morrison	F	58	March Avenue
Lucas Ahmed	M	82	Hinckley Street
Steffen Wills	M	50	Barclay Road
Alexandre Schwarz	M	26	Hudson Place
Hyung Bale	M	43	Waldemar Avenue
Irina-Camelia Wilson	F	37	Chelmsford Street
Carrie Spellerberg	F	67	Walker Court
Nourhan Benfeito	F	48	Calvin Place
Blaza Frolov	F	72	Eastmont Road
Hongxia Tan	F	38	Sherwood Court
Jane Hornsey	F	64	Garrison Street
Berengere Saholinirina	F	62	Clearwater Drive
Arturs Swann	M	69	Cawfield Street
Claudia Metu	F	80	Whitman Street
Emmeline Vasilionak	F	82	Woodlawn Street
Jessica Richter	F	89	Roys Street
Veronika Wruck	F	37	Ennis Road
Jessie Mikolajczyk	M	20	Old Road
Henk Lee	M	34	Pelham Street
Wenjun Taimsoo	F	31	Brown Avenue
Stefany Parra	F	44	Greenbrier Street
Lisa Edgar	F	79	Museum Road
Candace Hennaoui	F	62	Myles Standish Road
Riki Solomon	M	25	Wainwright Street
Francisco Lahbabi	M	68	Cheryl Lane
Kristina Liess	F	16	Keane Road
Adonis Kitchens	M	85	Orton Marotta Way
Jorge Apithy	M	62	Jay Street
Ineta Whalan	F	42	Glenellen Road
Cassidy Iguodala	F	23	Shetland Street
Mark Arrighetti	M	44	Spofford Road
Johana Carman	F	87	Tyndale Street
Deni Hazewinkel	M	72	Bennett Street
Reza Egelstaff	M	59	Rumford Road
Alain Peguero	M	30	President Road
Jaime Shevchenko	F	66	Bray Street
Csaba Martin	M	24	Rosedale Street
Fabiano Rouba	M	26	Ring Road
Tejitu Tago	F	34	Richards Street
David Hegazi	M	69	Ruskindale Road
Casey Gantumur	F	44	Brier Road
Allan Liu	M	58	Macdonald Street
Muradjan Maeda	M	26	Carlton Street
Suyeon Bolkvadze	F	23	Harlow Street
Julie Henriques	F	43	Muller Avenue
Natalie Barbosa	F	24	Alameda Road
Jacobine Fowles	F	29	Haverhill Street
Alexander Filipovic	M	37	Manila Avenue
Xiaoyu Yang	F	71	Grantley Street
Nakyeong Lin	F	87	Market Street
Alexandre Smedins	M	72	Johnston Road
David Ramirez	M	65	Gridley Street
Nicholas Hornsey	M	35	Commodore Terrace
Joe Germuska	M	65	Plainfield Street
Simon Truyens	M	61	Corona Street
Peng Kim	M	46	Linnet Street
Olga Puga	F	37	Westville Street
Gideon Davies	M	54	Aberdeen Avenue
Song Rutter	M	44	Middlesex Street
Jessica Hemthon	F	54	Scottfield Road
Andriy Lukashyk	M	53	Mercantile Street
Hyo Ponsot	M	17	Ventura Street
Anastasia England	F	19	Hartlawn Road
Katerina Saenz	F	32	Springvale Avenue
Hiroyuki Meye	M	55	Gove Street
Ehsan Yamazaki	M	53	Belnap Road
Carmelita Zahmi	F	74	Branch Street
Iryna Prieto	F	30	Blandford Street
Isiah Murabito	M	62	Clermont Street
Nicholas Mitchell	M	64	Orkney Road
Ronja Marroquin	F	57	Dickens Street
Zhuldyz Hoxha	F	32	Wilkinson Park
Alfonso Jneibi	M	59	Kennebec Street
Xiang Wukie	M	56	Warrenton Place
Zhuldyz Machado	F	77	Colchester Street
Hansle Plesnieks	M	33	Raynes Road
Michael Stublic	M	28	Claridge Terrace
Tobin Niwa	F	62	Fairlane Road
Sinta Denisov	F	60	Main Street
Mikhail Polaczyk	M	90	Louis Prang Street
Renee Duenas	F	27	Yarmouth Street
Todd Kalmer	M	44	Costello Circle
Marit Mickle	F	78	Savoy Street
Paul Kitamoto	M	47	Carson Street
Beata Pascual	F	81	Breck Avenue
Alexis Mallet	M	46	Herrick Street
Franklin Koala	M	86	Mansfield Street
Wilson Sauvage	M	46	Swift Street
Stephanie Kieng	F	87	Churchill Avenue
Jeneba Lee	F	39	Elmore Street
Shane Dodig	M	81	Mountfair Terrace
Hao Janovic	F	17	Johnny Court
Bedan Soubeyrand	M	64	Augustus Avenue
Kurt Fayez	M	82	Battery Street
Dieter Schooling	M	22	Thingvalla Avenue
Ai Portela	F	86	Elmer Road
Sara Smith	F	31	Scribner Road
Florian Filova	M	68	Parkway Road
Fabiana Hortness	F	64	Arborcrest Terrace
Soslan Sefik	M	21	Shrewsbury Road
Saleh Brockl	M	54	Thurston Street
Mingjuan Birgmark	F	85	Hunter Street
Franck Elkhedr	M	50	Bispham Street
Ali Milthaler	M	63	Barker Street
Andrea Wenger	M	68	Farwell Avenue
Masashi Angilella	M	47	Orton Marotta Way
Ligia Tancock	F	72	Grantley Street
Rebecca Orlova	F	68	Catenaccia Way
Ali Jallouz	M	46	Lorraine Street
Takamasa Gogaev	M	49	Queen Street
Olga Nguyen	F	17	Coleman Street
Lauryn Powrie	F	42	Hannon Street
Marry Kubala	F	21	Emerson Place
Carolina Kawasumi	F	50	Kingsley Street
Azad Honeybone	M	78	Way Street
Witthaya Cragg	M	38	Tierney Street
Jordis Botia	F	28	Yorktown Street
Jamaladdin Dalby	M	74	Hayes Road
Lisa Peralta	F	62	Carruth Street
Binyuan Kumagai	M	59	Wakullah Street
Arnaud Feck	M	28	Acton Street
Erika Owens	F	56	Trapelo Street
Jochen Montoya	M	79	Brookview Street
Marcin Guderzo	M	67	Church Street
Ander Moolman	M	70	Hansborough Street
Radoslav Susanu	M	35	Gloucester Street
Christian Negishi	M	84	Endicott Court
Karen Brandl	F	88	Dayton Street
Ana Reilly	F	85	Windermere Road
Aleksandar Atafi	M	77	Webber Street
Ilya Saito	M	23	Snow Street
Sarah Herrera	F	72	Byrd Avenue
Oleg Dyadchuk	M	33	Mills Street
Elisabeth Santos	F	90	Scottfield Road
Kasper You	M	56	Alleyne Street
Shuai Sudarava	F	53	Rhoades Street
Andreia Tambwe	F	17	Baldwin Place
Patricia Zhang	F	83	Bismarck Street
Silvia Nakamoto	F	78	Garfield Avenue
Annie Vadlejch	F	58	Cleaves Street
Jussi Nesti	M	44	Bunker Street
Yasunari Jokovic	M	53	Dumas Street
Toea Robert-Michon	F	72	Sparrow Street
Matyas Lopez	M	48	Alleghany Street
El Rooney	M	37	Needham Road
Megan Raymond	F	74	Meehan Street
Gretta Tang	F	89	Vale Court
Paolo Sirikaew	M	33	Bradshaw Street
Zac Ashwood	M	50	Iona Street
Niclas Calzada	M	55	Alaric Street
Glenn Gonzalez	M	50	Briarcliff Terrace
Dzmitry Busienei	M	55	Harmon Street
Ruta Trowbridge	F	79	Common Street
Edith Sofyan	F	30	Earhart Street
Carlos Liu	M	41	Havey Street
Gabrielle Raudaschl	F	69	Merrimac Street
Urs Kim	M	60	Marbury Terrace
Kristian Yamaleu	M	61	Wedmore Street
Jan-Di Aydarski	F	27	Knowlton Street
Michael Melchor	M	88	Margaret Street
Pedro Prieto	M	86	Mora Street
Kateryna Ayhan	F	53	Custom House Street
Lee-Ann Song	F	30	Ayr Road
Cornel Bernotas	M	50	Wareham Street
Olena Turei	F	29	Nantasket Avenue
Cian Adem	M	65	Yerxa Road
Sangjin Hindes	M	81	Wabash Street
Rattikan Prapakamol	F	52	Ruffing Street
Adrian Lidberg	M	26	Fairfax Street
James Yallop	M	43	Myopia Road
Deokhyeon Khinchegashvili	M	64	Varick Road
Zsombor Chammas	M	30	Michael Road
Donald Guderzo	M	83	Lime Street
Robert Loch	M	56	Allston Court
Anna Holzdeppe	F	20	Plover Street
Alexander Vandermeiren	M	72	Ukraine Way
Satomi Li	F	31	Plummer Place
Marie-Pier Schultze	F	55	Lorenzo Street
Yuhan Kari	F	22	Hammond Street
Lisa Zheng	F	50	DeWolfe Street
Emanuel Hanany	M	64	Weymouth Avenue
Jianfei Erokhin	M	81	Lindsey Street
Colin Nakayama	M	88	Youngs Road
Jordan Voglsang	M	43	South Waverly Street
Shota Rakonczai	M	63	Safford Street
Anna Rosario	F	27	Winchester Street
Bin Iersel	M	77	Tuckerman Street
Anastasiya Rupp	F	82	Queen Street
Ilya Marcano	M	71	Woodland Place
Katarina Girard	F	42	Lamson Court
Ivan Nimke	M	47	Main Street
Chu Jones	M	85	O Street
Yutong Olaru	M	74	Stellman Road
Heshan Rogers	M	72	Pickering Avenue
Alessandra Vicente	F	65	Langdon Street
Saso Morais	M	42	Rushmore Street
Alexey Hammadi	M	27	Comet Place
Lukas Gong	M	70	Webber Street
Tyson Knezevic	M	82	Pelton Street
Teresa Henriques	F	78	Rawson Street
Troy Garrigues	M	22	Lasell Street
Sandra Kaukenas	F	51	Mother Julia Road
Eric Rouba	M	50	Water Street
Yin Toma	M	89	Crown Point Drive
Romain Haig	M	63	Symmes Street
Braian Haydar	M	21	Barclay Road
Ayako Coetzee	F	80	Seaver Place
Stanislav Krug	M	18	Coronado Road
Mercy Brusquetti	F	80	Russell Street
Kristina Hochstrasser	F	49	Harvey Street
Ye Fitzgerald	F	82	Houghton Street
Katerina Filali	F	51	Frisbie Place
Jessie Vlahos	M	20	Brookvale Street
Kyong-Hui Ragymov	F	81	Beechcroft Street
Nadia Jung	F	79	Tanglewood Road
Luis Booth	M	31	Alwin Street
Teresa Andrewartha	F	73	Altacrest Road
Cheikhou Lepchenko	M	23	Lamartine Place
Oleksiy Mejia	M	75	Woodgate Street
Dorian Sauer	M	49	Inman Court
Jeemin Tyler	M	65	Carpenter Street
Stephen Nunes	M	40	Harrington Avenue
Diletta Tindall	F	24	Halifax Street
Stefano Moniqui	M	35	Gilmer Street
Silja Abdusalomov	F	70	Emmet Street
Ricardo Barnaby	M	86	Fainwood Circle
Alexandros Pla	M	65	Divinity Avenue
Doyler Protsenko	M	86	Wildwood Street
Jaqueline Shcherbatsevich	F	88	Norwell Street
Isabel Boccard	F	34	Seaver Place
Kelsey Lopez	F	44	Amboy Street
Margaret Gao	F	39	Sleeper Street
Megumi Liu	F	59	Dickens Street
Jiyeon Timina	F	46	Barclay Road
Njisane Saleh	M	89	Coleman Street
Diego Smith	M	71	Camelia Avenue
Meghan Lidberg	F	77	John Alden Road
Saulius Sinnig	M	23	Clay Street
Ning Knowles	F	72	Weitz Street
Jo Lai	F	60	Theodore Parker Road
Craig Cassara	M	70	West Boundary Road
Hung Mutlu	M	78	Baldwin Place
Byambatseren Resch	F	42	Dunwell Street
Sidni Sze	M	47	Gardner Place
Jaime Zhang	M	26	Pleasant Valley Circle
Kira Richards-Ross	F	86	Stuart Street
Amanda Svensson	F	47	Humphreys Place
Andre Horvat-Panda	M	44	Cottage Park Avenue
Enzo O'shea	M	30	Elder Street
Ewelina Enganamouit	F	57	Bobolink Street
Samson Burgaard	M	77	Cornelia Street
Darya Dorado	F	26	Loring Place
Anfisa Whalan	F	48	Hartland Street
Wai Schoeman	F	63	Sherbrook Street
Mhairi Tremblay	F	44	Hillcroft Road
Olga Mekic	F	45	Belnap Road
Rita Gabriele	F	61	Oakmere Street
Haley Deetlefs	F	63	Como Road
Marharyta Khakhlova	F	24	Havre Street
Rayan Titenis	M	68	Larch Place
Andreas Sinia	M	59	Mount Ida Road
William Girard	M	58	New Frontage Road North
Winston Li	M	85	Athens Street
Vladimir Frayer	M	50	Fountain Street
Agnieszka Iersel	F	64	Seattle Street
Marzia Novikau	F	86	Arch Street
Dmitriy Bartman	M	53	Shepard Court
Jessica Fukumoto	F	44	Creighton Street
Ibrahima Byrnes	M	20	Oldfields Road
Kateryna Matei	F	24	Fidelis Way
Ludivine Schuerch	F	24	Tupelo Street
Huajun Kerber	F	77	Cutter Road
Tom Dvorsak	M	33	Wiget Street
Sin Cambage	F	25	Dudley Court
Olivia Valencia	F	65	Egleston Street
Mi-Gyong Chen	F	55	Clarkson Street
Kazuki Leroy	M	74	Manassas Avenue
Jozef Stefansson	M	44	Garden Lane
Joanne Tankeeva	F	89	Derry Road
Ndeye Heylen	F	29	Lillian Street
Linda Rotaru	F	33	Wood Avenue
Florent Aleh	M	42	Sidley Road
Yahima Menkov	F	83	Antrim Street
Yibo Al-Jumaili	F	66	Euclid Street
Rasul Tichelt	M	27	Kneeland Street
Ryunosuke Hagan	M	82	Newbury Street
Jessica Lee	F	65	Avondale Street
James Pohrebnyak	M	48	Wallingford Road
Victoria Davis	F	46	Mount Everett Street
Sascha Bentley	M	44	Camelia Avenue
Keigo Lekai	M	25	Woodbridge Street
Dana Hassnaoui	F	65	Oakview Avenue
Norma Anderson	F	67	Harris Avenue
Ryan Fogg	M	39	Paula Road
Inaki Milanovic-Litre	M	33	Agassiz Park
Sergey Abalo	M	75	Wallingford Road
Adrienne Kreanga	F	30	Curley Street
Kim Estrada	F	76	Glide Street
Valentina Teschke	F	23	Brinsley Street
Hovhannes Piccinini	M	74	Lee Hill Road
Panagiotis Mucheru	M	80	Ricker Terrace
Joshua Ovono	M	64	Bancroft Street
James Seferovic	M	64	Bond Street
Rachelle Cherniavska	F	63	Jamaicaway Court
Nacissela Makarau	F	77	Millers Lane
Irawan Souza	M	62	Shepherd Avenue
Jessica Basalaj	F	17	Amherst Street
Kimberly Yu	F	84	Fresno Street
Max Lee	M	59	Hamlet Street
Bogdan Beaubrun	M	74	Orchard Park Street
Diletta Sukochev	F	70	Moloney Street
Haley Pishchalnikov	F	76	Ravenna Road
Nastassia Wu	F	45	Orton Marotta Way
Kay Tramer	M	65	Maplewood Street
Sultan Wilson	F	34	Curtis Street
Jessica Ochoa	F	62	Wirt Street
Amel Ochoa	M	42	Clevemont Avenue
Yue You	M	74	Ocean Street
Marios Lima	M	34	Cawfield Street
Kwan Scherer	M	46	Silver Street
Norman Weltz	M	17	Vinal Street
Delfina Lindfors	F	74	Ashton Place
Astrid Kusznierewicz	F	68	Woodbrier Road
Gisela Sampson	F	19	Ricker Terrace
Felipe Kechrid	M	18	Donnell Street
Camille Zhang	F	51	Homestead Street
Wilson Duong	M	40	Ritchie Street
Ronald Mehelba	M	62	Leyden Street
Mikolaj Sawa	M	45	Alna Place
Jillian Lalova	F	38	Ronan Street
Emma Celustka	F	71	Kenrick Street
Nicolas Rapinoe	M	69	Beechwood Street
Simone Abrantes	M	47	East Second Street
Christopher Wilson	M	30	Asticou Road
Lisa Wang	F	79	Humboldt Avenue
Matthew Toth	M	69	Winthrop Street
Maxime Tatishvili	M	57	Abbot Street
Milan Emmolo	M	84	Cheryl Lane
Anne Houghton	F	48	Houston Street
Diana Fedoryshyn	F	53	Brockton Street
Milcah Kosarev	F	41	Bogandale Road
Charlotte Taylor	F	55	Frisbie Place
Carole Pyatt	F	41	Fairfax Street
Kelly Olivier	F	74	Sherwood Court
Martin Martin	M	43	Stanley Street
Christina Vesela	F	35	Traveler Street
Sook-Ja Lindback	F	80	Mount Vernon Place
Nicolas Wells	M	73	Grouse Street
Dragan Murphy	M	82	Sylvester Road
Joel Tverdohlib	M	55	Noble Court
Silvia Konukh	F	85	Moreland Street
Jinyan Bernard-Thomas	F	46	Duxbury Road
Michael Giorgio	M	26	Mount Ash Road
Martino Wallace	M	73	Lawton Street
Richard Timofeeva	M	32	Seaver Place
Henk Mrvaljevic	M	41	Plymouth Street
Frank Awad	M	42	Easton Avenue
Chen Moulinet	M	69	Trapelo Street
Jitka Mottram	F	73	Cerdan Avenue
Eric Lemaitre	M	77	Reservoir Avenue
Giorgia Borisenko	F	60	Potosi Street
Joanna Dlamini	F	54	Museum Road
Dawoud Atari	M	40	Savannah Avenue
Thomas Cronje	M	59	Suncrest Road
Wei White	F	16	Pinehurst Street
Premysl Michel	M	36	Mitchell Street
Bridget Usovich	F	73	Blue Hill Avenue
Carl Paischer	M	48	Ewer Street
Aylin Maurer	F	21	Lexington Avenue
Attila Sullivan	M	50	Cottrell Street
Zsofia Wang	F	18	Florian Street
Suji Gallantree	F	78	Westmoor Circle
Ebrahim Baggaley	M	36	Marston Street
Silvia Wambach	F	77	Gilmer Street
Jemma Mayr	F	81	Brush Hill Lane
Michael Sjostrand	M	87	Fairbanks Street
Ayele Bleibach	M	22	Woodbine Street
Florent Gu	M	89	Tiverton Road
Piotr Rabente	M	24	Greenock Street
Magdalena Kondratyeva	F	20	Woodbrier Road
Riaan Idlette	M	69	Thirteenth Street
Sa-Nee Saldarriaga	F	20	Tenney Street
Siraba Davenport	F	16	Hooten Court
Ivan Christou	M	48	Cromwell Road
Kaspar Brown	M	18	Jordan Road
Morten Kasprzak	M	28	Clarkson Street
Kenny Chavanel	M	25	Gore Street
Laura Neben	F	26	Millstone Road
Murilo Valenzuela	M	61	Rutherford Avenue
Tomasz Jang	M	78	Wakefield Avenue
Jung Jung	F	66	Elba Terrace
Ekaterina Hernandez	F	44	Groom Street
Asafa Robles	M	67	Robey Street
Evagelos Felix	M	51	Kingsland Street
Micah Pigot	M	48	Vining Street
Youngran Inthavong	F	33	Rowley Street
Winder Jongjit	M	63	Tomahawk Drive
Kristian Surgeloose	M	61	Bungalow Road
Micah Smith	M	77	Herbertson Road
Mel Quinonez	F	26	Armory Street
Lucy Maguire	F	68	Middleton Street
Birsel Siladi	F	16	Dedham Parkway
David Ferreira	M	16	Pearl Street
Daniel Jackson	M	71	Warwick Park
Sergiy Markt	M	66	Mallon Road
Mohammed Sakamoto	M	42	Fisher Avenue
Nicolene Jeong	F	53	Arborfield Road
Edgars Meshref	M	21	Tarleton Road
Martina Voronov	F	25	Jamestown Terrace
Inaki Murphy	M	62	Colebrook Street
Michael Chapman	M	59	Carver Street
Mouni Malaquias	F	89	Balmoral Park
Iryna Radovic	F	74	Elbow Street
Vicente Adams	M	49	Ashmore Road
Marcos Laukkanen	M	43	Wesley Place
Salma Cely	F	19	Friendship Road
Sergey Zurrer	M	75	Webster Avenue
Ingrid Hayes	F	29	Arbutus Street
Ryan Porter	M	40	Virginia Street
Aida Olesen	F	43	Hunter Street
Simas Takahashi	M	20	Glenhaven Road
Jean-Christophe Kirkham	M	32	Don Street
Pedro Harper	M	27	Whitford Street
Vincent Robinson	M	86	Belnap Road
Zhongrong Stacchiotti	M	84	Morley Street
Christos Jo	M	75	Cameron Avenue
Alexandr Hamaguchi	M	62	Richfield Park
Anna Jaskolka	F	81	Ivy Street
Alexander Obermoser	M	38	Iowa Street
Marc Gebremedhin	M	86	Margaret Street
Alexey Gille	M	49	Edge Hill Street
Haruka Joo	F	47	Starbird Avenue
Chong Massialas	M	28	Laval Street
Mathias Longosiwa	M	45	Tafts Avenue
Mireia Lindh	F	27	Walk Hill Street
Fiona Wiggins	F	50	Elizabeth Street
Periklis Gemmell	M	74	Randolph Street
Victor Labyad	M	78	Windham Road
Kate Bourihane	F	71	Sixteenth Street
Kelsey Grumier	F	86	Frederika Street
Oleksandr Englmaier	M	69	Brookway Road
Nguyen Ozolina-Kovala	F	60	Oliver Street
Charles He	M	59	Lawrence Avenue
Lea Mohsen	F	33	Senders Court
Simon Randall	M	63	Johnson Avenue
Jarred Selimau	M	76	Manthorne Road
Glen Randa	M	20	Lebanon Street
Francena Savchenko	F	84	Zeigler Street
Brice Agliotti	M	46	Back Street
Mattia Sundstedt	M	54	Sanford Street
Teerawat Drouin	M	29	Concord Avenue
Yutong Pena	M	76	Ardmore Road
Lukasz Rodrigues	M	63	Bungalow Road
Zalina Bascou	F	46	Rockmount Street
Younggwon Fabre	M	83	Doctor Mary Moore Beatty Circle
Robyn Sigmond	F	61	Moulton Street
Lidia Glover	F	71	Frisbie Place
Antonija Dilmukhamedov	F	52	Halford Road
Luisa Hultzer	F	83	Mansfield Street
Debora Moguenara	F	51	Brookfield Street
Carlos Caianiello	M	23	Puritan Avenue
Nikola Zhang	M	40	Front Street
Adam Moreno	M	16	Matthews Street
Daniele Carrascosa	M	79	Carpenter Street
Moses Sihame	M	55	Rowley Street
Hanna Khugaev	F	26	Auburn Street
Sven Vandenbergh	M	46	Emery Road
Maria Morgan	F	56	Blakeslee Street
Takayuki Ramirez	M	35	Kershaw Road
Alexander Welten	M	63	Morris Street
Yasunari Inzikuru	M	35	Ridgeview Avenue
Nenad Moran	M	22	Tina Avenue
Daniela O'malley	F	69	Union Park Street
Lei Takeda	M	26	Pearl Street Place
Yu Moradi	M	28	Sherbrook Street
Jihye Gregorius	F	86	Harriet Street
Cesar Joppich	M	20	Beach Street
Savannah Kleen	F	48	Roxana Street
Martin Webster	M	65	Oakley Street
Nadezda Plouffe	F	17	Moody Street
Timo Caglar	M	29	Marston Street
Daniela Schleu	F	46	Beecher Street
Rohan Braun	M	35	Mayfield Street
Luisa Vala	F	85	Lanark Road
Sebastian Flores	M	35	Beach Point Place
Serghei Alhasan	M	63	Lochdale Road
Maziah Govorov	F	71	Stockwell Street
Nestor Grabuste	M	49	Carroll Street
Brijesh Glynn	M	32	Granfield Avenue
Agnieszka Lindgren	F	56	Josephine Street
Younghui Hu	F	46	Cushing Avenue
Artem Sanchez	M	35	Corona Street
Genzebe Green	F	46	Oliva Road
Kurt Multerer	M	82	Buick Street
Alexandru Govers	M	27	Hopestill Street
Kyung Steffensen	M	17	Medallion Avenue
Gulnar Kowalska	F	64	Telegraph Street
Giovanni Kovacevic	M	84	Transportation Way
Bjoern Markt	M	46	Coffey Street
Christinna Hudnut	F	83	Trident Street
Andrea Tuzinsky	M	44	Colchester Street
Kay Kouassi	M	30	Rockford Street
Sabine Houghton	F	35	Alcorn Street
Clark Abdalla	M	22	Stella Road
On Varga	F	47	Manthorne Road
Emmanuel Arkhipova	M	84	Ellsworth Avenue
Samuel Folkard	M	87	Crossman Street
Danila Henao	M	80	Rugby Road
Rutger Mareghni	M	76	Lochland Road
Ying Dancette	F	71	Alfred Street
Bilel Karth	M	33	Schuyler Street
Yoo Miller	M	30	Stanton Street
Egor Vasile	M	40	Western Avenue
Sam Lahnsteiner	M	61	Plainfield Street
Stefan Li	M	84	Goethe Street
Alexander Lohvynenko	M	19	Meehan Street
Ahmet Polishchuk	M	61	Harrishof Street
Aleksejs Collins	M	63	Maria Lane
Marisa Silva	F	54	Valencia Road
Lihua Ivanova	F	78	Wrentham Street
Yang Yin	F	77	Bullard Street
Collis Freimuth	M	44	Arklow Street
Milan Blagg	M	87	Galty Avenue
Po Otsuka	F	60	Long Avenue
Arezou Alfaro	F	46	Vogel Street
Joanna Ayvazyan	F	41	Saint Rose Street
Vincent Cogdell	M	62	Moreland Street
Federico Pavoni	M	46	Drummond Place
Tatsuhiro Thompson	M	29	Chilton Road
Mizuho Bennett	F	26	Lotus Street
Daniel Worthington	M	62	Haviland Street
Ari-Pekka Wei	M	46	Edmunds Street
Hyunsung Ivancsik	M	38	McTernan Street
Carine Karakus	F	58	Tonawanda Street
Chui Aymerich	F	18	Kingsdale Street
Rasmus Honeybone	M	63	Lorraine Street
Ana Tursunov	F	65	Parkwood Terrace
Madonna Girke	F	41	Pheasant Street
Mohamed Thomas	M	16	Stow Road
Roland Madaj	M	66	Clare Avenue
Anna Prucksakorn	F	68	Waldeck Street
Mikhail Napoleao	M	64	Charles Park Road
Briken Stankovic	M	67	Damrell Street
Giedrius Calja	M	36	Brookford Street
Byron Lezak	M	61	Jeffers Street
Ines Wong	F	60	Babcock Street
Goran Driouch	M	49	Pleasant Avenue
Candida Gu	F	49	Schrepel Place
Gerald Afroudakis	M	48	Desmond Road
Aymen Bespalova	M	70	Franklin Hill Avenue
Sabine Moffatt	F	50	Peaceable Street
Beth Andrade	F	34	Glenmore Street
Patricia Bauer	F	28	Rice Circle
Tim Ortiz	M	83	Duxbury Road
Mylene Haywood	F	69	Alna Place
Hortance McGlinchey	F	17	Glade Avenue
Petra Berdych	F	87	Gladeside Avenue
Sabrina Burns	F	77	Presley Road
Andrea Desta	F	26	Boston Street
Angelique Raden	F	61	Dunkeld Street
Mohammad Li	M	54	Smith Field Road
Eduarda Bartonova	F	58	Sheldon Street
Laura Assefa	F	70	Cogswell Avenue
Ivana Lee	F	43	Hackensack Circle
Brendan Hanany	M	35	East Service Road
Brooke Albegov	F	18	Blanche Street
Sara Siriteanu	F	16	Park Lane Drive
Zouhair Ri	M	34	Pacific Street
Tiff Fehr	F	20	Richard Avenue
Gulcan Burling	F	47	Sharp Street
Emanuele Oulmou	M	39	Francesca Street
Tarjei Clary	M	33	Millstone Road
Brady Ruciak	M	48	Water Street
Maria Yim	F	29	Leicester Street
Nadeen Carrasco	F	29	Dwinell Street
Tonci Schneider	M	76	Stockwell Street
Matias Tait	M	59	Border Street
Linus Tran	M	16	Prescott Place
Almensh Tuara	F	87	Rhoades Street
Almat Lucas	M	66	New Street
Aretha Joensen	F	17	Birchwood Street
Sascha Wruck	M	68	Pinckney Street
Kelis Beliaeva	F	35	Glencliff Road
Jose Paldanius	M	56	Peninsula Place
Marcin Cele	M	81	Vineland Street
Sergey Britton	M	40	Trent Street
Radoslaw Licona	M	75	Belvidere Street
Melanie Gibson-Byrne	F	87	Strathcona Road
Yannick Toumarkin	M	21	Parish Street
Jong de	F	85	Waterman Road
Alberto Gryn	M	38	Robey Street
Kelly Kulish	F	54	Brookvale Street
Beate Masson	F	57	Clare Avenue
Ihor Costa	M	41	Itasca Street
Mei Stettinius	F	19	Whitfield Street
Amy Jo	F	35	Gem Avenue
Jenny Flognman	F	28	Clementine Park
Rares Kim	M	23	Bloomfield Street
Donggeun Guion-Firmin	M	52	Gold Star Road Court
Nicole Kovalev	F	82	Granby Street
Philipine Hansen	F	28	Osborn Street
Komeil Matheson	M	77	Endicott Court
Stefanos Hoecke	M	48	Caledonia Avenue
Thomas Song	M	43	Granfield Avenue
Crisanto Saikawa	M	63	Arion Street
Brahim Wang	M	52	Shannon Street
Joris Tallent	M	31	Columbus Avenue
Jane Trotter	F	60	Kimball Lane
Rubie Eldin	F	17	Saint Albans Road
Mink Clos	M	89	Cambridgeside Place
Natalie Cheverton	F	48	Letitia Way
Andreas Quiyuch	M	82	Maverick Square
Leandro Jayasinghe	M	41	Grady Court
Edgar Pistorius	M	60	Priscilla Road
Robert Dent	M	28	Rustic Road
Emanuel Taleb	M	32	Greaton Road
Marc Atici	M	40	Dania Street
Stefanie Thi	F	71	Slayton Way
Melissa Luycx	F	16	Brookledge Street
Sebastian Gadabadze	M	37	Martinwood Road
Matthew Richards-Ross	M	63	Eleanor Street
Tsimafei Helebrandt	M	26	Dalkeith Street
Mervyn O'malley	M	21	Victoria Street
Francisco Irvine	M	74	Buswell Street
Marcus Birmingham	M	36	Medford Street
Fatma Savitskaya	F	49	Wareham Street
Andrei Pognon	M	88	Beaver Place
Jaele Sharp	F	64	Daly Street
Alan Thibus	M	86	Lena Terrace
Steven Solomon	M	25	Highfield Road
Nicolas Dotto	M	34	Snowhill Street
Gauthier Siemion	M	58	Glenside Avenue
Iker Franek	M	55	Frederika Street
Yauheni Sokolowska	M	83	Park View Street
Taizo Barry	M	31	Shepton Street
Maximiliano Han	M	33	Train Street
Kevin Okori	M	77	Braeburn Road
Jamina Costa	F	60	Randolph Street
Revaz Melfort	M	82	Hazel Street
Miguel Cho	M	23	Vogel Street
Thomas Peralta	M	21	Edgewater Drive
Diogo Bazayev	M	79	Lubec Street
Leford McConnell	M	47	Cabot Street
Rosa Murray	F	69	Hazelmere Road
Nathan Frederiksen	M	28	Rundel Park
Ayman Kaliberda	M	90	Fenelon Street
Chun Liukkonen	M	26	Gerrish Street
Kwan Otsuka	M	64	Glenway Street
Ancuta Emmons	F	75	Randolph Street
Donald Ritzel	M	29	Saint Charles Street
Tervel Rojas	M	74	Curlew Street
Barbara Hutten	F	51	Florida Street
Jarrin Kolev	M	48	Jette Court
Hamdan Zabelinskaya	M	27	Juliette Street
Samira Ri	F	61	Senders Court
Ahmed Weir	M	18	Lincoln Lane
Malin Archibald	F	35	Louis Prang Street
Bruno Tomas	M	65	Montmorenci Avenue
Jiawei Koedooder	F	46	Saint Rose Street
Marcia Ser	F	68	Brown Avenue
Rand Fanchette	F	50	Short Road
Luigi Marshall	M	34	Irena Road
Yerzhan Poulios	M	57	Greenview Avenue
Lukasz Afroudakis	M	44	Robbart Lane
Hawley Raguib	F	48	Glines Avenue
Nicolene Louafi	F	72	Westford Place
Ediz Gorlero	M	81	Furbush Road
Marcus O'leary	M	51	Bicknell Street
Hansle Bentley	M	79	Holworthy Place
Desiree Kavcic	F	63	State Street
Schillonie Benaissa	F	72	Sanborn Avenue
Kim Smith	M	47	Eastern States Road
Vasilij Blouin	M	86	Hestia Park
Sebastian Yonemoto	M	69	Kensington Park
Sebastian Lelas	M	48	Hubbardston Road
Kyuwoong Pacheco	M	76	Messinger Street
Joy Ide	F	36	Nonquit Street
Tetsuya Cabrera	M	33	Snow Street
Arseniy Pais	M	35	Mapleton Street
Xiuyun Ellington	F	90	Arborview Road
Xavier Hayashi	M	18	Transportation Way
Vincenzo Kermani	M	20	Waldemar Avenue
Roger Kaeufer	M	44	Sunnybank Road
Anastasia Gal	F	20	Danville Street
Kerron Bracciali	F	42	Granby Street
Nguyen Barshim	F	16	Charles River Avenue
Sara Campbell	F	39	Anita Terrace
Emma Hausding	F	19	Selma Street
Charlotte Kachalova	F	68	Aldworth Street
Charles Wang	M	90	Glenmont Road
Margaux Knox	F	28	Melrose Street
Kathleen Marennikova	F	85	Edgemont Street
Alicja Kamionobe	F	24	Burard Street
Wesley Truppa	M	66	Claymoss Road
Riza Bleasdale	M	65	Mother Julia Road
Pimsiri Panchia	F	19	Brainard Street
Kate Thurmond	F	24	Congress Street
Mary Wallace	F	24	Kilby Place
Ekaterina Perera	F	77	Hutchings Street
David Dawidowicz	M	29	Logan Street
Azneem Sharapova	M	19	Benson Street
Alexei Schuh	M	37	Gardner Place
Marvin Peltier	M	73	Cambria Street
Nicolas Gyurov	M	78	Estey Street
David Ahouanwanou	M	64	Mechanic Street
Ellie Danilyuk-Nevmerzhytskaya	F	55	Louis D Brown Way
Kien Shi	M	81	William Jackson Avenue
Lidia Kakiiwa	F	48	Slocum Road
Andreas Okruashvili	M	79	Claxton Street
Shu-Ching Ribas	F	87	Bosworth Street
Sarah Kozlov	F	37	Brookfield Street
Mervyn Nelson	M	84	City Point Court
Omar Jon	M	79	Paul Sullivan Way
Olena Abysova	F	60	Sedgwick Street
Kris White	M	72	Walker Street Place
Mikalai Bassaw	M	80	Harbor Crest Court
Chen Perunovic	M	30	Emily Street
James Rosic	M	47	Atherton Avenue
Iryna Malcolm	F	83	Egleston Street
Zhiwen Piron	M	66	Shafter Street
Jurgen Arndt	M	77	Owencroft Road
Euan Gunnarsson	M	68	Melrose Street
Danijel Pyhyda	M	48	Macullar Road
Sebastian Sorribes	M	22	Cheshire Street
Benjamin Schlosser	M	83	Surrey Street
Anna Tomic	F	67	Speridakis Terrace
Melissa Motsalin	F	31	Burrell Street
Brittany Askarov	F	20	Tileston Street
Hanna Holusa	F	43	Victor Street
Rafaela Sato	F	30	Violet Street
Natasha Haywood	F	20	Stanbro Street
Andres Deng	M	84	Roseglen Road
Reina-Flor Savlinis	F	51	Edmunds Street
Kara Lansink	F	67	Mohawk Street
Juan Tourn	M	61	Eastwood Court
Aksana Zhang	F	28	Wellesmere Park
Joachim Jennings	M	20	Woodmont Street
Gwen Fredricson	F	28	Cotuit Street
Osku Groot	M	36	Corbet Street
Jerry Winther	M	34	Egan Way
Kosta Buff	M	34	Causeway Street
Christian Godin	M	34	Beechland Street
Alvaro Tanatarov	M	64	Rhoda Street
Sergey Leiva	M	69	Courtney Road
Tim Cambage	M	38	Cufflin Street
George Rupp	M	62	Kenberma Road
Peng Masai	M	39	Ginita Street
Sophie Graff	F	47	Chapin Avenue
Pierre-Alexis Zhang	M	69	Gate House Road
Roxana Edoa	F	35	Gwinnett Street
Spas Dawson	M	76	Fowle Street
Yunwen Crous	F	17	Way Street
Marcelinho Pendrel	M	18	Sidney Place
Athanasia Ayling	F	42	Guild Street
Cedric Skarlund	M	73	Arbutus Street
Ariel Villar	M	89	Quinn Way
Radmila Nibali	F	73	Pleasantview Street
Tyler Borisenko	M	83	Christopher Street
Arlene Navarro	F	77	Seymour Street
Gabor Hochstrasser	M	45	Burney Street
Nigel Hejmej	M	85	Donnell Street
Nataliya Southern	F	62	Malcolm Road
Sarah Guzzetti	F	18	Forbes Street
Angela Belmonte	F	20	Msgr Lydon Way
Werner Totrov	M	90	Sutherland Road
Morgan Chan	F	22	Meadow Road
Daria Lohvynenko	F	48	Haskell Street
Maksim Culley	M	59	Hendry Street
Lucia Maksimovic	F	57	Ansonia Road
Dunia Paton	F	38	Boynton Street
Samantha Lin	F	90	Dietz Court
Zohra Bryant	F	38	Vancouver Street
Camille Andersen	F	49	Ridgeway Lane
Maoxing Bedik	M	85	Landseer Street
Alise Bellaarouss	F	27	Lenoxdale Street
Svenja Marennikova	F	90	Santuit Street
Zhiwen Wu	M	85	Thacher Court
Luca Melendez	M	24	Bradfield Avenue
Ken Roland	M	66	Le Fevre Street
Casey Hardy	M	25	East Sixth Street
Rosie Tempier	F	85	Higgins Street
Krystian Kean	M	70	Deerfield Street
Harry Velikaya	M	71	Yarmouth Street
Ronald Veiga	M	78	Porter Circle
Annari Simmonds	F	28	Westminster Avenue
Cristian Ghasemi	M	64	Ledgebrook Road
Liubov Johansson	F	38	Gardenside Street
Grega Horton	M	34	Ivory Street
Li Brown	F	27	Theodore Glynn Way
Pedro Egelstaff	M	45	Alton Court
Roxana Srebotnik	F	37	Lingard Street
Diego Tarasenko	M	37	Hartlawn Road
Ana Williams	F	21	Gerald Road
Alexander Kurbanov	M	17	Charme Avenue
Zsuzsanna Ozaki	F	81	Brookline Avenue
Alix Dziamidava	F	75	Old Rutherford Avenue
Amina Pesce	F	68	Coventry Street
Nathalie Ionescu	F	48	Barlow Street
Pierpaolo Williams	M	41	Rector Road
Aniko Blume	F	20	Alcorn Street
Jonathan Perez-Dortona	M	87	Gibson Street
Laure Idowu	F	27	Noah Street
Hotaru Jones	M	34	Taft Court
Andrija Schulz	M	20	Rockford Street
Mariko Hidalgo	F	33	Bloomfield Street
Line Burgis	F	72	Peter Parley Road
Noureddine Filipe	M	84	Clermont Street
Robin Kazakevics	M	33	Rozella Street
Barbora Parellis	F	60	Balina Place
Lukas Jang	M	40	James Shea Circle
Becchara Batkovic	F	45	Alaska Street
Fernanda Hall	F	32	Von Hillern Street
Krzysztof Vesovic	M	49	Haverford Street
Viktoriia Mathlouthi	F	46	Allenwood Street
Adam Li	M	47	Pierpoint Road
Natalia Child	F	27	Chandler Street
Shara Green	F	74	Baldwin Place
Shuai Muttai	F	58	Brook Farm Road
Eve Pessoa	F	40	Edge Hill Street
Nastassia Croenen	F	21	Lombard Street
Azad Lavanchy	M	48	Catenaccia Way
Bence Peng	M	29	McDonald Avenue
Marcel Hedoui	M	53	Salisbury Park
Vitali Oliver	M	83	Rockmere Street
Alfredo Kiryienka	M	85	Cedrus Avenue
Anastasia Biannic	F	57	Corinne Road
Sarra Larsen	F	37	Saco Street
Jessica Garderen	F	56	Carver Street
Dana Potent	F	87	Beech Street
Angelica Lopez	F	42	Fort Avenue
Gabriela Weir	F	37	Ferndale Street
On Schops	F	18	Rita Road
Ligia Czakova	F	25	Commercial Street
Carl Roux	M	81	Marginal Road
Agnieszka Baker	F	19	Farrin Street
Elena Quinonez	F	36	Albemarle Court
Eric Rolin	M	68	Barnes Avenue
Stephane Palelashvili	M	79	Lynnville Terrace
Hongyan Collins	F	37	Armstrong Street
Blazenko Ostling	M	34	Glenwood Avenue
Massimo Groot	M	36	Alpheus Road
Gabrielle Lidberg	F	28	Father Songin Way
Jana Yudin	F	51	Kearsarge Avenue
Iuliia Oatley	F	23	Healey Street
Angelina Ligeti	F	44	Carlton Street
El Gonzalez	M	54	Matthew Street
Yu Kozhenkova	F	45	Rowena Street
Suzaan Craig	F	35	Sonoma Street
Luol Mooren	M	52	Cummins Highway
Shea Zhang	M	71	South Walter Street
Chloe Santos	F	86	Galileo Galilei Way
Michael Orjuela	M	37	Noble Court
Roc Bari	M	80	Millmont Street
Daniel Basalaj	M	50	Southwood Street
Bruno Oliver	M	88	Fenelon Street
Maik Bobadilla	M	84	Newcroft Circle
Eduard Carboncini	M	25	Cambridge Parkway
Karen Rew	F	54	Tobin Bridge
Saori Dancette	F	16	Atkinson Street
Woojin Nazaryan	M	84	Stanhope Street
Michal Rochus	M	16	Mattakeeset Street
Bashir Krovyakov	M	86	Drapers Lane
Maiko Osborne	F	66	Carleton Street
Yong Slater	F	64	Itasca Street
Raphael Hardee	M	61	Readville Street
Omar Aguirregaray	M	49	Hunter Street
Guillermo Silva	M	79	Fulda Street
Alberto Fiakaifonu	M	90	Drummond Place
Damian Baki	M	28	Vining Street
Lukasz Draudvila	M	89	Stockton Street
Emily Chow	F	20	Cardington Street
Stanislav Dorneanu	M	84	Rich Street
Rustam Bashore-Smedley	M	20	Charlesview Street
Ewelina Hwang	F	22	Spalding Street
Georgina Zuniga	F	37	Peacock Lane
Katerina Galvez	F	48	Charlemont Street
Nataliya Nielsen	F	62	Dover Street
Jennifer Medwood	F	54	Dalkeith Street
Melaine Souleymane	F	30	Mansen Court
Monika Heidler	F	32	Enneking Parkway
Sarah Kim	F	26	Chellman Street
Dagmara Balla	F	77	M Street Place
Ji Stewart	F	28	Storrow Drive
Selim Cook	M	51	Oxford Avenue
Abdelrahman Ruiz	M	29	Colebrook Street
Amy Zaiser	F	36	M Street Place
Kaori Donahue	F	45	Torpie Street
Mattia Nalbandian	M	71	Quincy Court
Milan Ekberg	M	19	Zeigler Street
Lucas Ren	M	31	Franklin Hill Avenue
Viktorya Schmidt	F	70	Woodland Place
Philip Hilario	M	19	American Legion Highway
Katsiaryna Lang	F	25	List Place
Matthew Juaneda	M	20	Thornton Place
Christopher Isaychev	M	44	Harris Avenue
Bernardo Thompson	M	70	Bellvista Road
Ruoqi Nowak	F	59	Mooney Street
Meiliana Berglund	F	53	Denny Street
Chay Trefil	M	38	Fenwood Road
Kaori Silva	F	51	Sussex Street
Caba Mandic	M	22	Vose Avenue
Grit Nascimento	F	41	Vicksburg Street
Bolade Rubino	M	19	Knoll Street
Bogdan Michel	M	48	Wellesmere Park
Kamila Sakari	F	42	Maybury Street
Bilel Boonsawad	M	41	Liberty Place
Lorena Marenic	F	59	Iowa Street
Vanessa Sato	F	29	Way Street
Tarik Atangana	M	80	Leverett Avenue
Esref Pikkarainen	M	30	Chetwynd Road
Byungchul Bouqantar	M	58	Call Street
Nelly Rumjancevs	F	79	Wilna Court
Rachel Kostelecky	F	71	Alder Street
Dauren Khokhlova	M	17	Berwick Street
Martin Sireau	M	50	Alvarado Avenue
Bundmaa Wei	F	84	Saint Andrew Road
Marcelien Hosnyanszky	F	27	Gene Street
Julieta Pars	F	83	Lyford Street
Pavlo Stewart	M	41	Lyon Street
Victoria Abarhoun	F	55	Barrett Avenue
Carla Farrar	F	34	Elton Street
Kelita Webster	F	47	Patten Street
Husayn Robinson	M	77	Veterans Of Foreign Wars Parkway
Nagisa Leroy	F	30	Roslindale Avenue
Svetlana Quah	F	76	Hazel Street
Franck Kondratyeva	M	89	Sexton Court
Wan-Jung Gasol	F	19	Michelangelo Street
Michal Stahlberg	M	62	Weybosset Street
Luiza Nocher	F	42	Holden Street
Alexandros Grumier	M	32	Charlotte Street
Janay Jorgensen	F	29	Wesley Place
Corinna Guzzetti	F	28	Crown Street
Artur Le	M	75	Tonawanda Street
Hamid David	M	46	Glencliff Road
Stuart Gaitan	M	67	Plover Street
Petrus Gionis	M	79	Lowney Way
Weiyi Kirpulyanskyy	M	21	Minden Street
Navab Povh	M	85	Lynde Street
David Moutton	M	71	Danforth Street
Mariana Selimau	F	75	Atherstone Street
Nanthana Chen	F	77	Cunard Street
Tsvetana Jennings	F	84	Edith Street
Joris Schulze	M	69	Fairbury Street
Sergii Tellechea	M	29	Balmoral Park
Tomasz Gkountoulas	M	45	Senders Court
Fernanda Armstrong	F	54	Robin Hood Street
Leyla Szabo	F	17	Dawson Street
Boon Gasol	M	34	Thomas Park
Satomi Xian	F	31	Fermoy Heights Avenue
Charline Daly	F	60	Stanhope Street
Toni Karpova	M	25	Worcester Square
Iain Hartig	M	51	Arborway
Hursit Gestel	M	36	Greenfield Road
Wouter Brennauer	M	52	Belnel Road
Mansur Engleder	M	90	Roxbury Street
Nurul Han	F	80	Adella Place
Angelica Meylink	F	31	Crossman Street
Habibollah Zieminski	M	58	Rockmount Street
Shane Lima	M	83	Morrison Court
Hongmei Kuehner	F	66	Nancy Road
Dani Loukas	F	84	Bloomington Street
Xin Cuddihy	F	32	Farragut Road
Beata Altes	F	60	Woodworth Street
Juan Osl	F	16	Southbound Frontage Road
Yumeka Rejepov	F	56	Henchman Street
Grete Makaranka	F	44	Greenough Avenue
Malte Passier	M	80	Traymore Street
Glenn Liivamagi	M	87	Arion Street
Bianca Dumerc	F	62	Bluefield Terrace
David Perez	M	25	Driscoll Drive
Darlenis Helal	F	60	Craftsman Street
Carla Anderson	F	58	Norwell Street
Joyce Cuevas	F	86	Dorset Street
Milena Wojnarowicz	F	63	Farnsworth Street
Darya Wu	F	79	Greenleaf Street
Nathan Nishikori	M	24	Nonantum Road
Tianyi Boughanmi	M	58	Longwood Avenue
Kiril Larsson	M	33	Hunnewell Avenue
Liam Ahmed	M	57	Annavoy Street
Brian Boyer	M	39	Harbor Point Boulevard
Helge Pitkamaki	M	48	Cheever Court
Diego Saedeleer	M	17	Ramsdell Avenue
Eva Markussen	F	17	Ruskindale Road
Nenad Nikic	M	76	Mckenna Terrace
Yongseong Kuziutina	M	44	Cambridgepark Drive
Darae Hidayat	F	44	Orient Avenue
Lalita Wang	F	39	Westmount Avenue
Zuzana Maroiu	F	48	Castlegate Road
Drew Prygorov	M	57	Ashley Street
Ranohon Montano	F	53	Hawes Street
Zoltan Kromowidjojo	M	39	A Street
Abdullah Jiao	M	60	Mosgrove Avenue
Hanna Huang	F	31	Mansen Court
Jennifer Johnson	F	52	Mystic Street
Lei Lee	F	54	Glenham Street
Sara Friis	F	20	Saint Theresa Avenue
Luigi Sofyan	M	65	Meshaka Street
Nelson Meilutyte	M	44	Ardmore Road
Audrey Martin	F	77	Channing Circle
David Oldershaw	M	53	Woodhaven Street
Lisa Poistogova	F	17	Westacott Court
Jonas Ukumanov	M	29	William Street
Gyujin Nikolaev	M	22	Ellwood Street
Andy Arms	M	31	Colbert Street
Anna Hirano	F	55	Valley Road
Hiram Blume	M	38	Port Lane
Maja Garcia	F	39	Ridge Street
Helen Beaubien	F	28	Converse Street
Svetlana Janoyan	F	87	Branchfield Street
Peter Schuch	M	29	Dorchester Avenue
Georgina Oldershaw	F	56	C Street
Jamie Kim	F	40	Woodbourne Road
Vladimir King	M	41	Sibley Court
Annika Samoilau	F	86	Ringefield Street
Anja Abakumova	F	30	Rockland Avenue
Stina Perova	F	20	Garner Road
Antonina Raif	F	88	Maynard Place
Rui Loukas	M	31	Standish Street
Mate Montano	M	52	Tuttle Street
Yuliya Sokolov	F	33	Rich Street
Gwang-Hyeon Mears	M	63	Mapes Street
Eric Silva	M	19	Tucker Street
Rubie Sukhorukov	F	20	Morley Street
Kumi Lewis-Francis	F	79	Telford Street
Burcu Bacsi	F	82	Westwind Road
Marouan Ilyes	M	49	Minden Street
Madonna Kim	F	52	Wabon Street
Ciaran Han	M	55	Oliver Street
Ross Nakamura	M	56	Blandford Street
Eloise Balooshi	F	47	Ogden Street
Rachel Burrows	F	39	Dean Street
Wenyi Bompastor	F	54	Staniford Street
Oluwasegun Annabel	M	37	Mattapan Street
Milka Spiegelburg	F	63	Howland Street
Rosie Golas	F	70	Joyce Road
Larissa Zhu	F	21	Ocean Street
Edward Tatham	M	51	Cambria Street
Steven Slater	M	81	Father Songin Way
Antonia Gercsak	F	36	Marney Street
Yonas Farrell	M	47	Brent Street
Jennifer Rutherford	F	75	Buckman Street
Roderick Lipatov	M	50	Marmion Street
Tereza Marzalyuk	F	36	Dacy Street
Suzaan Dawkins	F	31	Thetford Avenue
Didier Munoz	M	42	Norman Street
Abeba Alamiyan	F	39	Georgetowne Drive
Raigo Turner	M	71	Rosebery Road
Fabienne Horvat-Panda	F	89	Curlew Street
Ole Suhr	M	49	Quaker Lane
Alin Wilson	M	34	Thirteenth Street
Endene Samsonov	F	57	Saint Andrew Road
Ates Wenger	M	84	Cordis Street
Simeon Hausding	M	33	Patten Street
Isiah Lacuna	M	37	Alfred Street
Jing Sprunger	F	89	Medfield Street
Marcel Sigurdsson	M	90	Sleeper Street
Salah Rivers	M	66	Waterloo Street
Lauren Johnson	F	85	Necco Court
Eran Babaryka	M	36	Clement Avenue
Louisa Bassaw	F	26	Geneva Avenue
Ho Thunebro	F	22	Traveler Street
Johnno Listopadova	M	63	Kenwood Street
Karina Jelaca	F	30	Dighton Street
Jennifer Marco	F	37	Margo Road
Huizi Accambray	F	79	Day Square
Sandra Gomez	F	45	Gove Street
Aaron Santos	M	66	Normandy Avenue
Kristine Lynsha	F	59	Callender Street
Francisco Cochrane	M	20	Martha Road
Richard Warren	M	86	Vinson Street
Clemens Cordon	M	90	Donna Terrace
Cedric Subotic	M	79	Winborough Street
Enzo Balciunas	M	71	Wilbert Circle
Juri-Mikk Vecchi	M	21	Gwinnett Street
Katrien Na	F	43	Rutherford Avenue
Pawel Coetzee	M	21	Charles Road
Erlon Hurd	M	78	Bromfield Street
Siham Moura	F	49	Wycliff Avenue
Vasilij Wang	M	46	Camden Place
Ryan Paulo	M	46	Harbor Street
Jonathan Endrekson	M	31	Rockingham Avenue
Adelina Grzybowska	F	36	Massport Haul Road
Mohamed Kazakevic	M	79	Balsam Street
Ai Lovtcova	F	58	Lowell Street
Xiaoxiang Lan	M	58	Cambridgeside Place
Ioannis Mcmenemy	M	60	Trask Street
Nahla Tyler	F	81	Saint Rose Street
Donggeun Harada	M	63	Haviland Street
Emanuele Siegelaar	M	77	Front Street
Ling Langridge	F	62	Petrel Street
Vincent Krsmanovic	M	18	Common Street
Richard Scarantino	M	21	Monsignor Casey Highway
Florian Mihamle	M	27	Melville Avenue
Natalia Neben	F	54	Arborough Road
Liubov Ruh	F	48	Wilrose Street
Xiang Pocius	M	49	Front Street
Wenling Aguiar	F	55	Northampton Street
Teklit Zheng	M	24	Melton Road
Monique Szecsi	F	23	Peninsula Place
Kathleen Nakano	F	20	Birch Road
Hawley Hunter	F	77	Bowdoin Avenue
Nicholas Filippov	M	24	Orleans Street
Mikhail Vlcek	M	82	Moloney Street
Rebecca Simon	F	56	Balsam Street
Colin Vila	M	84	Roberts Place
Hilder Zairov	M	71	Yarmouth Street
Geraint Traore	M	76	Shafter Street
Karolina Wells	F	31	Sheldon Street
Marcelinho Hrachov	M	83	Cordis Street
Casey Basic	F	40	Lesher Street
Norbert Feldwehr	M	18	Norumbega Street
Susan Weidlinger	F	80	Havre Street
Julian Lie	M	21	Stinson Court
Bastian Horvat-Panda	M	21	Hunnewell Avenue
Oliver Mokoka	M	18	Lynde Street
Rushlee Krsmanovic	F	27	Madeline Street
Christopher Stafford	M	36	Vineyard Street
Ivan Nakai	M	57	Albemarle Court
Benjamin Noumonvi	M	84	Brannon Harris Way
Ali Wang	M	52	Bay View Place
Maksim Chibosso	M	70	Camden Place
Astrida Roche	F	37	Farnham Street
Perri Staut	F	77	Laban Pratt Road
Braian Osayomi	M	43	Wendeller Street
Nina Tomic	F	51	Kenrick Street
Yue Zargari	M	48	Norfolk Avenue
Olga Maguire	F	41	Lambert Avenue
Lankantien Parker	M	64	Woodbourne Road
Toshiyuki Nyasango	M	32	Tyler Court
Ever Levins	M	44	Anawan Avenue
Kay Coster	M	84	Carson Street
Nurmakhan Hurst	M	29	Dracut Street
Man Kim	M	57	Murray Avenue
Marianne Quioto	F	51	Dixfield Street
Annemiek Arikan	F	30	Alexander Street
Claudine Baltacha	F	44	Stratford Street
Carlos Sekaric	M	49	Burlington Avenue
Maria Aramburu	F	18	Montclair Avenue
Robyn Mortelette	F	86	Penryth Street
Gelly Alipov	F	21	Oakton Avenue
Dongpeng Kleen	M	76	Allston Court
Bohdan Kuhnle	M	50	Armandine Street
Jorge Lambert	M	67	Montana Street
Jirina Hojka	F	18	Brimmer Street
Victoria Homklin	F	49	Hawthorne Park
Hristo Avan	M	72	Dove Court
Moussa Fernandez	M	48	Sedgewick Road
Lucie Yang	F	66	Greymere Road
Maksim Loza	M	25	Brookvale Street
Glenn Defar	M	31	Hansborough Street
Tina Ortiz	F	39	Presley Road
Deron Tarasova	M	41	Kerna Road
Bruno Szarenski	M	84	Morrell Street
Ivan Contreras	M	32	Egremont Road
Katarzyna Talay	F	76	Carrolton Road
Gloria Dean	F	67	Sherbrook Street
Jehue Zolnerovics	M	21	Kelton Street
Cristian Dobek	M	69	Mount Pleasant Avenue
Lauren Jaballah	F	66	Oak Place
Ondrej Kitchens	M	68	Marlborough Street
Timothy Zhang	M	33	Frances J Murray Way
Dane Montelli	M	88	Willard Street Court
Roland Deak-Bardos	M	66	Putnam Avenue
Tiexin Max-Theurer	M	67	Pearl Street Place
Gabriele Barcelo	M	72	Guilford Street
Cindy Narcisse	F	52	Tai Tung Street
Leire Saltanovic	F	37	P Street
Haiqi Popova	M	89	North Point Boulevard
Patrick Miles	M	87	Pleasant Valley Circle
Emma Chadid	F	49	Sawyer Avenue
Gulsah Makarova	F	84	Kelly Road
Sergej Yli-Kiikka	M	87	Hobson Street
Marianne Li	F	38	Saint Andrew Road
Glenn Yi	M	87	Edith Street
Artem Figere	M	43	Drake Place
Kanstantsin Christou	M	25	Spencer Street
Mykyta Euren	M	68	Village Court
Ivan Kim	M	33	Bard Avenue
Zach Esposito	M	76	Gould Street
Suzanne Warburton	F	77	Frawley Street
Anja Hsu	F	51	Chaucer Street
Desiree Khachatryan	F	60	Sylvester Road
Ivan Versluis	M	36	Danville Street
Eleftherios Bozbayev	M	46	Speridakis Terrace
Ser-Od Szasz	M	88	Foch Street
Ken Fularczyk	M	68	Agawam Street
Lisa Lanigan-O'keeffe	F	69	Royal Avenue
Kaori Lester	F	67	Westbrook Street
Oriol Gonci	M	23	Stedman Street
Georgios Gigli	M	62	Ditson Street
Nicolas Carou	M	50	Ernest Avenue
Jinhyeok Yamaguchi	M	44	Shannon Street
Mostafa Kleen	M	49	Factory Street
Dilshod Allen	M	37	Rollins Court
Lucinda Harada	F	65	Boyd Street
Caroline Warlow	F	51	Myopia Road
Bebey Adamski	F	25	Old Rutherford Avenue
Magaye Neagu	M	16	Nassau Street
Mikhail Laalou	M	50	Saint John Street
Kate Pink	F	54	Hubbard Park Road
Valerii Volikakis	M	55	Andrews Place
Marianne Muravyeva	F	17	Hawthorne Park
Dirkie Yun	F	17	Hunter Street
Erica Nakagawa	F	55	Saint Margaret Street
Wanida Barjaktarovic	F	89	Dewolf Street
Yifang Khudzenka	F	76	Saint Cecelia Street
Kathleen Schmidt	F	78	Canterbury Street
Ines Kovtunovskaia	F	29	Peabody Place
Jonathan Isaksen	M	42	Old Dee Road
Mathilde Ivanovic	F	73	Saint Thomas More Road
Yumeka Cipressi	F	72	Castleton Street
Fredy Ezzine	M	26	Tyler Court
Johannes Berna	M	27	Oakman Street
Caitlin Carli	F	17	Vineland Street
Ebrahim Maeyens	M	43	Theriault Court
Alex Kim	M	57	Harrishof Street
Christian Isinbaeva	M	69	Piedmont Street
Yik Akkaoui	M	46	Red Pine Road
Adnan Brendel	M	22	Scotia Street
Jessica Manker	F	70	Tremont Street
Hans Haldane	M	61	Fairview Avenue
Eloyse Vocht	F	75	Fabyan Street
Maryna Tyler	F	65	Tommy Leonard Bridge
Zi Stanning	F	30	Appian Way
Sultana Angelov	F	81	Robey Street
Marina Kasa	F	19	Florida Street
Malek Greeff	M	68	Knox Street
Laure Shanks	F	46	Cummings Road
Aaron Purevjargal	M	81	Corbet Street
Hedvig Diaconu	F	88	Edmunds Street
Josefin Ifadidou	F	74	Alvarado Avenue
Joerg Kikuchi	M	66	Hester Street
Ayman Suursild	F	37	Danbury Road
Evgeniya Protsenko	F	46	Wesley Place
Ana Pavia	F	82	Osborn Street
Danielys Butler	F	49	Garner Road
Eun Burton	F	43	Iowa Street
Majda Liu	F	22	Greycliff Road
Lindsay Guenot	F	80	Frisbie Place
Yuhan Ryang	M	60	Selkirk Road
Soren Dickens	M	71	Orchardhill Road
Betsey Cunha	F	35	Jarvis Place
Rizlen Mrisho	F	43	Alder Street
Sebastian Drame	M	31	Berkeley Place
Nikolaos Amertil	M	23	Babcock Street
Anna Tahmasebi	F	49	Sturbridge Street
Rena Jankovic	F	31	Costello Circle
Maria Kirkham	F	18	Almont Street
Camilla Terpstra	F	19	Fellsway Street
Ryo Smith	M	89	Rand Street
Lee Farris	M	18	Kilby Place
Myungshin Forgesson	F	71	Willard Street Court
Derek Aguiar	M	55	Bird Street
Natalia Sombroek	F	77	Fidelis Way
Iva Govejsek	F	89	Blue Hills Parkway
Kelley Nurmagomedov	F	63	Brookdale Street
Henna Causeur	F	64	Edson Street
Louise Ektova	F	52	Faneuil Street
Ashley Kukors	M	51	Oscar Street
Sonia Gillis	F	74	Woodward Avenue
Faicel Raudaschl	M	65	Antrim Street
Suwaibou Klemencic	M	72	Susanna Court
Elisabeth Wukie	F	17	Tennyson Street
Tatyana Mitrovic	F	77	Pontiac Street
Goldie Marais	F	71	Emrose Terrace
Sophie Giorgetti	F	74	Alcott Street
Gianluca Zhang	M	21	East Canton Street
Simone Morin	F	78	Thelma Road
Paula Pieters	F	43	Fairlawn Avenue
Rebecca Ruta	F	47	Drumlin Road
George Terpstra	M	32	San Juan Street
Edinson Rodrigues	M	29	Waterloo Street
Tom Ptak	M	80	Pond Circle
Michela Brown	F	39	Thrush Street
Natthanan Glaetzer	F	40	Carmen Street
Fineza Davis	F	59	Grahm Street
Sajjad Ulrich	M	75	Delmont Street
Alexandra Tang	F	42	Woodstock Avenue
Darae Elsayed	F	42	Monastery Road
Josefin QUINTERO	F	73	Platt Road
Wei Shi	M	38	Woodbridge Street
Joshua Fenclova	M	89	Shepard Court
Timothy Goffin	M	67	Catenaccia Way
Fabiana Kasyanov	F	45	Rosecliff Street
Wade Dimitrov	M	35	Boynton Street
Joline Enders	F	70	Lindall Place
Tyler Belmadani	M	60	Kalyda Park
Amy Mizzau	F	82	Mount Auburn Street
Igor Fredricson	M	37	Cunard Street
Cristian Bennett	M	59	Newcastle Road
Abby Cooper	F	90	Mccraw Street
Anders Correa	M	75	Presby Place
Jacheol Hyun	M	44	Drake Place
Peter Howieson	M	46	Woodbourne Road
Alfredo Polyanskiy	M	68	Piedmont Street
Natthanan Caluag	F	31	Melnea Cass Boulevard
Carolina Rondelez	F	35	Romar Terrace
Erwan Putra	M	82	Outlook Road
Xiangrong Palmer	F	74	Hull Street
Kyung-Ok Monaco	F	70	Speedway Avenue
Arantxa Lima	F	79	Georgetowne Drive
Juliane Kim	F	30	Keith Street
Stephanie O`regan	F	68	Peak Hill Road
Eunbi Jeon	F	44	Brandywyne Drive
Henri Navruzov	M	23	Bradeen Street
Anja Cojuhari	F	49	Keswick Street
Ratanakmony Baniotis	M	21	Rindge Avenue
Annabel Church	F	38	Buckingham Place
Rares Hsing	M	49	Richard Avenue
Travis Hammadi	M	17	Mount Bowdoin Terrace
Fionnuala Horst	F	44	Tonawanda Street
Matthew Lessard	M	20	Woodbole Avenue
Samantha Hantuchova	F	45	Woolsey Square
Murat Quintino	M	23	Hill Street
Alin Klaas	M	34	Munroe Street
Olena Kromowidjojo	F	71	Eleanor Street
Rafal Hartley	M	65	Bispham Street
Sergey Vasilionak	M	50	Lakeside Avenue
Matthew Jamal	M	44	Cataumet Street
Alejandra Bultheel	F	46	Chisholm Road
Marika Campbell	F	44	Brown Avenue
Maryna Desprat	F	27	Knoll Street
Joel Rogowska	M	21	Roseclair Street
Liuyang Darnel	F	48	Drumlin Road
Russell Bicet	M	70	Quint Avenue
Siham SCHIMAK	F	42	Fairlane Road
Jemma Modenesi	F	81	Webster Avenue
Jordi Raymond	M	72	Goff Street
Tim Han	M	40	Woodside Avenue
Ka Ilyes	M	56	Glenham Street
Abraham Benitez	M	90	Atlantic Avenue
Amine Najar	M	17	Meigh Road
Chris Keller	M	19	Topeka Street
Juan Crow	M	71	Wren Street
Dauren Smulders	M	25	Lochstead Avenue
Thierry Valiyev	M	41	Stanbro Street
Britany Charlos	F	84	Harborside Drive
Agnieszka Knittel	F	59	Thrush Street
Antonina Bernier	F	63	Cenacle Road
Murat Huertas	M	89	Dumas Street
Martino Mayer	M	62	Alna Place
Habibollah Williamson	M	45	Saint Gerard Terrace
Bubmin Rusli	M	72	Newhill Place
Georgina Stevens	F	56	Blagden Street
Radhouane Klamer	M	50	Bilodeau Road
Ka Caulker	M	45	Aldwin Road
Katerin Pliev	F	38	David G Mugar Way
Mark Turner	M	74	Manassas Avenue
Kathleen Jo	F	65	Commonwealth Avenue
Michael Hammarstrom	M	33	Mattakeeset Street
Grace Vieru	F	84	Bennington Street
Phathana Gadorfalvi	M	60	B Street
Jan Chavanel	M	17	Hardwick Street
Ponloeu Inthavong	M	27	Holden Street
Un Alberdi	F	44	Dighton Street
Madeleine Mitchell	F	34	Fainwood Circle
Todd Lewis-Smallwood	M	29	Ashcroft Street
Alana Thiam	F	52	Mishawum Street
Yun Milevicius	M	76	Swift Street
Pajtim Nesterenko	M	18	Ellison Avenue
Anna Martinez	F	75	Downey Court
Alexandra Jokinen	F	85	Rosemont Street
Marta Marjanac	F	55	Shea Road
Naomi Lush	F	32	Brainard Street
Haris Sinclair	M	44	Woodward Avenue
Timothy Li	M	17	Stimson Road
Ellen Smikle	F	48	Lester Place
Haibing Salvatori	F	58	Sedgewick Road
Johanna Khinchegashvili	F	35	Grafton Street
Joshua Grechishnikova	M	55	Willowdean Avenue
Helen Cheywa	F	86	Pasadena Road
Petr Angilella	M	69	Columbia Road
Gareth Culley	M	51	Marie Avenue
Arlene Ketin	F	30	San Juan Street
Brigitte Pishchalnikov	F	65	Stonehurst Street
Sofiane Satch	M	20	Selkirk Road
Diego Udovicic	M	40	Harvard Avenue
Wei Hazard	F	76	Plain Street
Mattia Saramotins	M	51	Clinton Place
Shane Choi	M	73	Delhi Street
Therese Stewart	F	78	World Trade Center Road
Simona Alayza	F	46	Kirkland Place
Bertrand Matlou	M	75	Avalon Road
Marit Silbereisen	F	30	Callender Street
Martina Campbell	F	63	Hastings Avenue
Aleksandar Sandell	M	64	Howes Street
Nadiya BAER	F	87	Fawcett Street
Polen Borel	F	89	Dietz Court
Maher Vos	M	55	Waltham Street
Kanae Bracciali	F	73	Wilna Court
Hanna Gynther	F	70	Andrews Place
Dion Pavlov	M	45	Cookson Terrace
Monica Suursild	F	82	Foster Place
Shugen Elkhedr	F	63	Walk Hill Street
Mohammad Jang	M	71	Viking Street
Ava Rusakova	F	79	Fawndale Road
Hakim Gomaa	M	18	Glenrose Road
Annabel Fuglsang	M	40	Haley Street
Diego Michan	M	74	Wyola Place
Bogdan Zavadova	M	88	Garnet Road
Viktor McLaughlin	M	19	Charles Park Road
Nadiezda Catlin	F	51	Woodgate Street
Derrick Jackson	M	22	Coleman Street
Luuka Zhang	F	19	Stearns Road
Julie Basha	F	54	Berkshire Place
Yeon-Koung Fernandez	F	66	Willers Street
Ondrej Dancette	M	67	Dumas Street
Hannah Gherman	F	36	Mannix Circle
Delwayne Boon	M	61	Radnor Road
Mara Deroin	F	63	Greenwich Court
Mattia Huber	M	88	Clematis Street
Guojie Paula	M	58	Edgerly Place
Louise Hirt	F	44	Elwell Road
Qing Sloma	F	84	Gerry Street
Abdalaati Rodriguez	M	38	Elmwood Avenue
Gustav Grabuste	M	65	Niles Street
Linus Cha	M	81	G Street
Helle Miankova	F	63	Brinsley Street
Zafeirios Ryu	M	86	Westmount Avenue
Carl Chapman	M	34	Saint Lukes Road
Pete Carrillo	M	60	Oneil Place
Elisa Ouedraogo	F	65	Donna Terrace
Mindaugas Saleh	M	63	Marlin Road
Rachel Jelcic	F	22	Alpheus Road
Nikola Alameri	M	56	James Street
Laura Sanca	F	66	Ely Street
Ai Siemion	F	21	Mallon Road
Tyson Tong	M	62	Ashcroft Street
Niki Batkovic	M	82	Newhall Place
Malin Barachet	F	68	Spurr Street
Rafael Vezzali	M	64	Tafts Avenue
Phylicia Sruoga	F	29	Flaherty Way
Bjorn Uwase	M	23	Margin Street
Shuo Emmanuel	M	62	Grieco Terrace
Roman Kim	M	63	Commercial Street
Destinee Kucana	F	57	Western Avenue Bridge
Casey Lei	F	19	Glendower Road
Christina Maneephan	F	46	Brookfield Street
Alison Leung	F	47	Wharf Street
Yun Dula	M	90	Gerrish Street
Tina Ipsen	F	28	Meadow Road
Aziz Chaabane	M	20	Donna Terrace
Daniel Havel	M	72	Neponset Valley Parkway
Daniel Alaskari	M	52	Hill Street
Celeste Lapi	F	34	Eileen Circle
Lleyton Houghton	M	61	Vicksburg Street
Haibing Lee	F	24	Marbury Terrace
Kerri Decosse	F	58	Hartlawn Road
Hans Bustos	M	48	Warwick Park
Russell Fukuhara	M	17	Clearway Street
Zara Luvsanlundeg	F	66	Farnsworth Street
Mare Hester	F	85	Keenan Road
Mathew Phillips	M	49	Ritchie Street
Matylda Muncan	F	47	Partridge Place
Sergey Almeida	M	55	Sackville Street
Mark Bennett	M	71	Orkney Road
Valentyna Townsend	F	81	Father Songin Way
Alexandr Liu	M	81	Newland Place
Victoria Mohamed	F	24	Butland Court
Simon Vollmer	M	34	Hunting Street
Sofya Mortelette	F	81	Halsey Road
Sultana Hayakawa	F	74	Reed Street
Xi Somogyi	F	19	Dorr Street
Miho Kwiatkowski	F	39	Bakersfield Street
Niclas Tymoshchenko	M	65	Stillings Street
Ciaran Susanu	M	90	Richmere Road
Volha Otsuka	F	89	Waterman Road
Tim Rodriguez	M	27	Beryl Street
Omar Salem	M	32	Robinson Street
Clara Ahye	F	72	Queen Street
Yuliya Davies	F	24	Kinnaird Street
Jessica Durasek	F	24	Osborn Street
Laura Wu	F	26	Glide Street
Peng Perez	M	72	Fieldmont Street
Petra Chang	F	79	Newcastle Road
Yuya Machtig	M	36	Blackstone Street
Kateryna Henzell	F	87	Crestwood Park
Olga Jankovic	F	27	Hastings Avenue
Ahmed Miyake	M	30	Knox Street
Constantina Nagel	F	60	Crane Street
Job Kretschmer	M	18	Vanderbilt Avenue
Ieuan Zbogar	M	38	Slayton Way
Adenizia Kim	F	58	Bateman Street
Marco Stanley	M	33	Ringefield Street
Zakari Isakov	M	62	Rosewood Street
Szabolcs Culley	M	40	East Service Road
Ruben Harrer	M	43	West Boundary Road
Marina Bidaryan	F	77	Blakeslee Street
Tremaine Uran	M	24	Johnston Road
Marco Sagmeister	M	24	Lorna Road
Ying Marinova	F	31	Brimmer Street
Benjamin Jeong	M	32	Tilman Street
Matteo Nieminen	M	30	Jenkins Street
Gavin Sobhi	M	60	Hathaway Street
Candace Nagga	F	45	Wadleigh Place
Israel Osman	M	70	Boston University Bridge
Marianna Moreno	F	41	Parkton Road
Tervel Pilipenko	M	28	Akron Place
George Liu	M	53	Milford Street
Julen Fogarty	M	21	Dana Avenue
Grete Skydan	F	39	Embassy Road
Julia Hirano	F	71	Devonshire Street
Trevor Peno	M	70	Violante Street
Anabel Mesfioui	F	44	Lansdowne Street
Kaylyn Chavanel	F	84	Maryland Street
Margaux Jung	F	29	Foster Place
Kum Musil	M	78	Newhall Place
Damian Kim	M	62	Ardale Street
Carli Kajuga	F	52	Woodbridge Street
Xiaojun Lee	M	78	Lena Terrace
Dana Zagame	F	16	Myrtle Avenue
Barbara Bruno	F	74	Chickatawbut Street
Russell Aidietyte	M	78	Glendale Street
Marcin Dyen	M	34	Alvan Terrace
Tatyana Charlos	F	80	Hautevale Street
Linda Njitam	F	34	Mendum Street
Thomas Frolov	M	72	Hadley Street
Hanna Takahira	F	79	Highland Park Avenue
Esther Churakova	F	35	Hamlin Street
Glencora Ebbesen	F	49	Copley Street
Xavier Kiprop	M	34	Mount Cushing Terrace
Bo Michalska	F	55	Standard Street
Emiliia Gebhardt	F	56	Rockvale Circle
Artur Teltull	M	30	East Lenox Street
Juan Lacrabere	M	27	Imbaro Road
Kelita Wood	F	27	Burgoyne Street
Wenwen Samilidis	F	51	Ferrin Street
Charline Lagutin	F	38	Fisher Avenue
Julien Buchanan	M	80	Elmdale Street
Anton Dlamini	M	16	Weitz Street
Tim Mankoc	M	73	Holborn Park
Tilak Raden	M	81	Emily Street
Anton Langehanenberg	M	85	Stimson Road
Jun Szczepanski	F	78	Halborn Street
Pilar Wilson	F	76	Firth Road
Illse Mylonakis	F	18	Bond Street
Viktor Steffens	M	43	Mariposa Street
Zakia Zhurauliou	F	82	Rustlewood Road
Onan Kim	M	78	Altair Road
Naphaswan Brownlee	F	80	Haydn Street
Marta Kiala	F	50	Brinton Street
Nikolay Jaramillo	M	47	Hamlet Street
Joseph Nolan	M	29	Bonad Road
Sebastian Iwabuchi	M	31	Bellevue Avenue
Asgeir Goffin	M	31	Stimson Road
Lyndsie Dudas	F	16	Orton Morotta Way
Shannon Lapeyre	F	53	Stedman Street
Jamaladdin Travica	M	59	Weaver Way
Anita Wright	F	55	Beecher Street
Lukas Hennaoui	M	41	Allandale Street
Laura Najah	F	83	Chase Street
Artiom Engin	M	21	Linden Avenue
Oscar Poistogova	M	49	Carleton Street
Pia Svensson	F	25	Dawes Street
Benjamin Kuramagomedov	M	50	Embassy Road
Kemal Dinda	M	47	Pilgrim Place
Bahar Febrianti	F	34	Sheldon Street
Kyeongha Kanerva	F	89	Ridgemont Street
Antoinette Silva	F	48	Saunders Street
Georgina Manojlovic	F	74	Fort Washington Place
Florencia Symmonds	F	23	Alaska Street
Kissya Choden	F	41	Lorraine Street
Jean-Julien QUINTERO	M	30	East Seventh Street
Frithjof Urtans	M	90	Corcoran Drive
Alhaji Burrows	M	49	Dock Street
Sarah Lokluoglu	F	80	Van Brunt Street
Rashed Head	M	65	Halford Road
Jan Ferreira	M	36	Midland Street
Louise Poewe	F	59	Banton Street
Eelco Berings	M	60	Wendeller Street
Ainhoa Taylor	F	89	Ash Street
Reyare Mogushkov	F	60	Mapleton Street
Natalya Mrabet	F	70	Sedgwick Street
Mie Callahan	F	26	Gladstone Street
Jason Vargas	M	46	Rosemont Street
Jongwoo Sin	M	87	Petrel Street
Arsen Monya	M	57	Gould Street
Jihyun Aljand	M	90	Lark Street
Fabiana Boussoughou	F	34	Judson Street
Kobe Driebergen	M	35	Loring Place
Ruth Wallace	F	20	Kendall Street
Layne Halsall	M	89	Wood Avenue
Alvaro Viljoen	M	67	Lawndale Terrace
Khetag Marinova	M	79	Richview Street
Ivana Grubisic	F	31	Fallon Place
Greg Girouille	M	35	Sutherland Road
Erik Astrand	M	46	Chilton Road
Andre Shimamoto	M	69	Ewer Street
Marion Kindzerska	F	43	Browning Avenue
Jake Prokofyeva	M	90	Theodore Glynn Way
Jing Aponte	F	53	Kennedy Road
Nada Francisca	F	45	Boutwell Street
Jan Shemberev	M	84	Brahms Street
Limei Ioannou	F	29	Victoria Street
Dmitrii Cureton	M	16	Carter Street
Saziye Phelps	F	44	Buchanan Road
Westley Febrianti	M	19	Euclid Street
Wael Li	M	73	Saint Albans Road
Ashlee Sakai	F	74	Haslet Street
Martyn Stasiulis	M	30	Springvale Avenue
Carmen Akkaev	F	29	Hobson Street
Darryl Soeda	M	24	C Street
Emmanuel Barbieri	M	63	Ventura Street
Richard Azcarraga	M	85	Monsignor Casey Highway
Haakan Koloyan	M	69	Van Norden Street
Elena Radovic	F	68	Robbart Lane
Suzanne Viguier	F	30	Rich Street
Janne Tallent	F	86	Bennet Street
Paul Tsakmakis	M	38	McClellan Highway
Aksana Baniotis	F	87	Roslyn Place
Moritz Muller	M	27	Bragdon Street
Rafael Yero	M	20	Forest Hills Entrance Drive
Amro Sokolov	M	57	Brookline Avenue
Petra Sakai	F	36	Burt Street
Ravil Ismail	M	25	Avila Road
Tsilavina Wozniacki	M	20	Carlos Street
Laura Ng	F	59	White Street
Veronique Caianiello	F	67	Farwell Avenue
Jelena Betanzos	F	79	Chester Park
Christian Brata	M	35	Broad Canal Street
Lina Bujdoso	F	16	Safford Street
Luigi Schwaiger	M	24	Asticou Road
Dan Sinker	M	20	Lovis Street
Sviatlana Yin	F	42	Condor Street
Christianne Kalmer	F	54	Melvin Avenue
Thomas Antonov	M	81	M Street Place
Ravil Mokoena	M	26	Caspar Street
Robert Choi	M	58	Redlands Road
Trevor Pirozhkov	M	75	Cawfield Street
Robert Lovtcova	M	36	Oakridge Street
Changwoo Rohde	M	44	Newsome Park
Andrei Kawamae	M	84	Saint Johns Road
Reine Huertas	F	23	Eileen Circle
Shaune Milevicius	M	46	Orlando Street
Dorde Leboucher	M	63	Loomis Street
Bruno Kiryienka	M	21	Parley Avenue
Ibrahima Csima	M	34	Whitcomb Avenue
Ashleigh Kiplagat	F	67	Oakley Street
Janelle Ovchinnikovs	F	83	Fulton Street
Andrea Lammers	F	51	Howe Street
Sayaka Vocht	F	44	Haverford Street
Lucia Berens	F	58	Stanbro Street
Christopher Phillips	M	66	Southmere Road
Krystian Pen	M	88	Glenmore Street
Nicola Saranovic	F	21	Lindsey Street
Monia Pavon	F	36	Prairie Street
Reika Elgammal	F	21	Dunster Road
Khetag Wagner	M	40	Seminole Street
Carlos Hjelmer	M	38	Trask Street
Yomara Setiadi	F	55	Irma Street
Austra Srebotnik	F	46	Rockview Place
Eric Babos	M	57	Academy Hill Road
Andrew Wang	M	71	Bishop Street
Andrew Monteiro	M	23	Barrett Avenue
Geir Brash	M	46	Alabama Street
Matthew Dalby	M	69	Bush Street
Nuria Kamionobe	F	82	Duncan Street
Sandrine Lapeyre	F	31	Waldeck Street
Sviatlana Kable	F	57	Fields Court
Bridgitte Bale	F	46	Fernboro Street
William Salminen	M	58	Ballou Avenue
Simon Martinez	M	58	Fenno Street
Tjipekapora Kurjo	F	28	Santuit Street
Mehdi Li	M	25	Sparhawk Street
Yasser Zavadsky	M	44	Reed Street Court
Ganna Zonta	F	41	Wendell Place
Hannah Jumah	F	74	Mamelon Circle
Sylwia Kiss	F	81	Dove Court
Jonas Ciglar	M	29	List Place
Anton Gu	M	83	Jamaica Place
Anastasia Cheng	F	19	Crossman Street
Lenise Liu	F	27	Spinelli Place
Lionel Shabanov	M	49	Bowen Street
Ruslan Filho	M	86	Mangano Court
Jorge Sornoza	M	40	Fidelis Way
Nicholas Ioneticu	M	56	Lamson Court
Ayouba Carrington	F	88	Blakeslee Street
Anuradha Colina	M	61	Babson Street
Alexander Sharland	M	60	Emily Street
Tonya Croenen	F	21	Guernsey Street
Laura Miankova	F	40	Esmond Street
Aleks Eisel	M	84	Garden Court Street
Mylene Murray	F	71	Beaumont Street
Jangy Scott-Arruda	M	67	Acacia Avenue
Lieuwe Schneider	M	84	State Street
Gavin Bauza	M	83	Banton Street
Luigi Luca	M	26	Deacon Street
Sergey Richard	M	25	Sciarappa Street
Eun Honrubia	M	82	Corcoran Drive
Yee Jiang	F	48	Deer Street
Kim Klaas	F	51	Bexley Road
Besik Unsworth	M	43	New Cypher Street
Erina Cabrera	F	28	Pleasantview Street
Dorothy Rossi	F	79	Wedgemere Road
Gemma Malki	F	50	Belden Street
Joao Shavdatuashvili	M	81	Hotel Drive
Giorgia Kleinert	F	87	McDonough Court
Kristina Quemada	F	33	Brunswick Street
Nocawe Zolnerovics	F	24	Leeds Street
Caroline Pistorius	F	76	Ennis Road
Fabiana Parsons	F	88	Parley Avenue
Tomas Rodriguez	M	61	Scribner Road
Dragos Han	M	88	Corbet Street
Sebastian Berdych	M	63	Verona Street
Vladimir Khousrof	M	33	Gerry Street
Katya Kindzerska	F	61	Albemarle Court
Dejen Paredes	M	22	Margaret Street
Ivan Penny	M	61	Bradlee Court
Sung Szucs	F	29	Burbank Street
Matti Othman	M	64	Robin Street
David Belete	M	25	Grant Place
George Santonja	M	54	Cowing Street
Konstantin Papachristos	M	68	Faraday Street
Ryan Pota	M	22	Sorrento Street
Andrea Kimani	F	28	Readville Street
Kyle Wang	M	73	Denny Street
Lynne Om	F	46	Upham Avenue
Riccardo Cheng	M	74	Granby Street
Sarolta Michelsen	F	19	Alveston Street
Kazushige Obiero	M	26	Ashmont Court
Zane Cane	M	30	Worrell Street
Pietro Walker	M	51	Gladstone Street
Gabor Cheverton	M	81	Astoria Street
Jacques Ramonene	M	56	Ryder Hill Road
Kelsey Bludova	F	85	Gates Street
Xing Varga	M	84	Elmer Road
Krisztina Petzold	F	48	Colorado Street
Ahmed Kurthy	M	77	Greenville Street
Camille Pryveda	F	56	Woodland Place
Diego Shing	M	47	Moultrie Street
Alex Moroz	F	77	Neptune Court
Yige Rhodes	F	35	Brahms Street
Niverka Ferraioli	F	63	Kimball Lane
Ayele Rouwendaal	M	37	Adelaide Street
Jackeline Caze	F	25	Churchill Avenue
Olga Asgari	F	67	Trowbridge Place
Sandrine Yumira	F	90	Dane Street
Carl Bekri	M	45	Verdun Street
Denes Venier	M	39	Exchange Place
Pedro Oliveira	M	21	Miner Street
Anna Savinova	F	69	Coleus Park
Kien Wade-Fray	M	79	Barrett Avenue
Adam Zaripova	M	47	Wayne Street
Tina Susanu	F	80	Fruean Place
Vanessa Millar	F	62	Harlow Street
Michael Stamatoyiannis	M	79	Tina Avenue
Natalia Benedetti	F	46	Aldrich Street
Azusa Perkins	F	19	McKone Street
Zurabi Zhou	M	88	Woodruff Way
Alexey Guloien	M	57	Hazelton Street
Ville Grandal	M	20	Allstate Road
Andrew Ruciak	M	47	Lovejoy Place
Melissa Sychra	F	52	Brookley Road
Joao Ziadi	M	62	Bromfield Street
Robert Dibaba	M	62	Cefalo Road
Marc Ivezic	M	77	Eagle Square
Andisiwe Ki	F	61	Lowney Way
Jorge Smelyk	M	37	Call Street
Ahmed Bortolanca	M	65	Summer Street
Minwoo Nazarova	M	17	Maffa Way
Jade Kopac	F	22	Rexford Street
Georgii Scheibl	M	51	Brook Avenue
Maria Banco	F	72	Regis Road
Arseniy Janik	M	43	Emelia Terrace
Yifang Narcisse	F	25	Trustman Terrace
Aleksandra Silva	F	61	Grantley Street
Maria Drais	F	78	Harborside Drive
Joseph Last	M	29	Condor Street
Karla Korstin	F	28	Ashcroft Street
Natthanan Mitchell	F	81	Conry Crescent Street
Telma Kryvytska	F	19	Gannett Street
Tavevele Kelly	M	89	Donnell Street
Yura Motsalin	F	76	Kemp Street
Brittany Crain	F	42	Reservoir Avenue
Marcin Cash	M	83	Fayerweather Street
Sungdong Willis	M	84	Munroe Street
Duane Skvortsov	M	87	Greycliff Road
Natalia Fettouhi	F	24	Grassmere Street
Levan Ingram	M	59	Fabyan Street
Maja Vila	F	63	Arborfield Road
Mandy Hinestroza	F	27	Codman Park
Thomas Aly	M	37	Montcalm Avenue
Tina Imboden	F	40	Harborside Drive
Pawel Jensen	M	16	Riverdale Street
Luis Ouedraogo	M	49	Ocean View Drive
Olga Jones	F	24	Horan Way
Daniel Herman	M	66	Gardena Street
Jerome Isaksen	M	58	Weymouth Avenue
Sonata Raif	F	50	Minnie Court
Marina Kim	F	17	Monument Avenue
Tejay Armitstead	M	82	Schubert Street
Eva-Maria Speirs	F	59	Brackett Street
Caitriona Moutoussamy	F	55	Livermore Place
Dalibor Gibson	M	89	Tovar Street
Vera Scarantino	F	44	Pinedale Road
James Siuzeva	M	51	Wave Avenue
Ak Terceira	M	62	Hillcrest Street
Zhe Hochstrasser	M	20	Salina Road
Billy Dyen	M	83	Newmarket Square
Olena Kyu	F	34	Whittemore Avenue
Florian Schrade	M	72	Mather Court
Nahla Zhedik	F	32	Hart Place
Kaori Coleman	F	81	Sanford Street
Torben Jaskolka	M	72	Birmingham Parkway
Lyndsie Norden	F	45	Montclair Avenue
Georgi Dent	M	62	Hilburn Place
Lina Kubiak	F	57	Allston Court
Gabriel Langridge	M	38	Danny Road
Fabio Simonet	M	80	Holman Street
Amanda Kalnins	F	50	Charlotte Street
Ashleigh Bruno	F	86	Glenellen Road
Jaromir Lawrence	M	71	Hinckley Street
Anqi Samlal	F	79	Etna Street
Sergey Lee	M	53	Proctor Street
Marcel Redhead	M	67	Dexter Street
Maksym Castillo	M	44	Denby Road
Karlo Romagnolo	M	83	Hemlock Road
Julia Kaniskina	F	61	Lake Shore Road
Kenny Faminou	M	29	Woodard Road
Gabor Almeida	M	76	Greenleaf Street
Mizuho Suetsuna	F	74	Pleasantdale Road
Patrick Faulkner	M	54	Westchester Road
Sara Jeong	F	88	Elbow Street
Benjamin Parker	M	65	Taber Street
Sandra Engelhardt	F	22	Roach Street
Stijn Choi	M	38	Alder Street
Ubaldina Ziegler	F	89	Bellvista Road
Mirac Ariyoshi	M	86	Wellington Hill Street
Lars Sobirov	M	71	Stanbro Street
Igor Dumoulin	M	86	Lindsey Street
Aleksei Wang	M	32	Abby Road
Igor Kasa	M	33	Bragdon Street
Francisco Feldwehr	M	90	Peters Street
Diego Dahlkvist	M	19	Brooksdale Road
Robin Padilla	M	56	Ritchie Street
Lars Kim	M	42	Derry Road
Milan Maksimava	M	87	Rock Hill Road
Yana Elmslie	F	84	Basto Terrace
Maurice Schornberg	M	24	Helena Street
Junggeu Firova	M	22	Marcella Street
Maria Arismendi	F	71	Armandine Street
Jean-Christophe Fujio	M	24	Plummer Place
Mohamed Soares	M	23	Patten Street
Dilshod Duong	M	70	Hague Street
Adrianti Tsirekidze	F	24	Alpha Road
Jessica Bolat	F	40	Albano Street
Jens Biadulin	M	89	Kensington Park
Lucie Kryvitski	F	80	Salisbury Park
Grzegorz Kohistani	M	36	Sorrento Street
Brent Queen	M	45	Edwin Street
Charles M'rabet	M	34	Jackson Circle
Ratanakmony Prutsch	M	45	Howland Street
Benjamin Hurtis	M	76	Cooney Street
Aliaksandr Ovinou	M	69	Lexington Avenue
Andrew Guilheiro	M	53	Lineham Court
Luke Mamedova	M	74	Leonard Avenue
Jiawei Crisp	M	30	Appian Way
Inna Yu	F	74	Radcliffe Road
Nguse Byrne	M	41	Trapelo Street
Shinichi Hahn	M	29	Caryll Street
Mikalai Kiryienka	M	17	Kineo Street
Benjamin Reinprecht	M	33	Badger Road
Ade Oconnor	M	18	Fairlane Road
Lea Besbes	F	87	Maitland Street
Toby Cao	M	48	Lebanon Street
Joyce Cesare	F	51	Athenaeum Street
Juan Oiwa	M	66	Kenilworth Street
Milena Vogel	F	56	Braintree Street
Sylwia Christian	F	38	Palermo Street
Sebastian Bayramov	M	25	Range Road
Austra Xu	F	74	Mount Ida Road
Cesar Qin	M	53	Brooks Street
Gonzalo Mirzoyan	M	63	Tomahawk Drive
Sarah Viudez	F	22	Violet Street
Eva Hirata	F	66	Prairie Street
Roberto Miller	M	81	Mozart Street
Jazmin Lee	F	37	Causeway Street
Mattias Kovtunovskaia	M	88	Maybury Street
Jacqui Maher	F	40	Andover Road
James Wierig	M	39	Sheldon Street
Elea Li	F	56	Shetland Street
Aleksandr Calder	M	79	Beaufort Road
Marcin Canitez	M	24	Argyle Street
Jack Shafar	M	35	Mamelon Circle
Hoi Martina	F	45	Westover Street
Konrad Haddad	M	72	Liverpool Street
Jessica Sprenger	F	89	Brattle Circle
Hyo Isakov	M	37	Alveston Street
Trey Kuczko	M	19	Stanbro Street
Vladimer Sorokina	M	68	Shelby Street
Isabelle Grigorjeva	F	39	Albert Street
Jacques Ide	M	56	Scotia Street
Olga Varnish	F	80	Preston Road
Francine Beaudry	F	52	Waterhouse Street
Jemma Wang	F	45	Emerald Court
Sarah Benie	F	34	Copeland Park
Martin Kergyte	M	44	Donnell Street
Olivier Akwu	M	35	Saint Saveur Court
Irina Tigau	F	54	Hathaway Street
Roline Rolin	F	63	Welland Road
Shuang Kravchenko	F	61	Drummond Place
Dora Veljkovic	F	27	Perrin Street
Jelena Febrianti	F	73	Macullar Road
Olga Brize	F	26	Brattle Circle
Akeem Ngake	M	57	Charbonnier Street
Yasser Watanabe	M	38	Stedman Street
Guor Rodhe	M	62	Byron Street
Vanda Bentsen	F	42	Arlington Avenue
Anthony Brugger	M	67	Barker Street
Martins Pipes	M	57	Baldwin Place
Mark Skudina	M	79	Ida Street
Julien Chen	M	16	Macdonald Street
Sergey Makanza	M	34	Litchfield Street
Minxia Yu	F	22	Fowler Street
Go Knioua	M	47	Stoughton Street Place
Fiona Granollers	F	39	Langford Park
Chien-Ying He	F	72	Hubbard Avenue
Westley Tatalashvili	M	51	Decatur Street
Niverka Junior	F	35	Hallwood Road
Dominic Al-Azzawi	M	84	Whittemore Avenue
Chiara Lewandowski	F	23	Mallon Road
Kari Boulleau	M	75	Saint Albans Road
Mohamed Onuora	M	43	Bartlett Avenue
Kamil Kintzer	M	25	Clipper Ship Lane
Almensh Zbogar	F	28	New England Avenue
Marry Azizi	F	86	Pleasantdale Road
Alexander Hansen	M	66	Kneeland Street
Olexiy Cheon	M	78	Liszt Street
Luis Goss	M	84	Otisfield Street
Ai REICHSTAEDTER	F	21	Margo Road
Paula Pamg	F	50	Catawba Street
Fortunato Deng	M	77	Athol Street
Abel Perez	M	24	Audrey Street
Anna Munch	F	80	Covington Street
Oliver Parti	M	40	Buckman Street
Adrian Melzer	M	45	Washburn Avenue
Haakan Okrame	M	75	Ferrin Street
Novak Solja	M	90	Armington Street
Muhamad Sadeiko	M	57	Rock Hill Road
Wassim Matsumoto	M	20	View South Avenue
Jaime Sonsirma	M	68	Coolidge Avenue
Kevin Giovannoni	M	24	Albemarle Court
Robert Kang	M	39	Tampa Street
Jolanta Walker	F	46	Northern Avenue
Craig Galvez	M	29	Edmunds Street
Par Awad	M	68	Bethune Way
Taisuke Mejri	M	80	Farmington Road
Kari Halsted	M	31	Dighton Street
Alistair McGeorge	M	56	Euclid Street
Gediminas Chen	M	22	Atherstone Street
Tania Kurban	F	71	Iona Street
James Hsiao	M	28	Shrewsbury Road
Xiaoyi Pulai	M	64	Riedesel Avenue
Risto Bertrand	M	52	Cook Street
Ferenc Nellum	M	75	Quincy Court
Ilya Pessoa	M	58	Wabash Street
Junghyun Filipovic	M	23	Devine Way
Francisco Lips	M	71	Mattapan Street
Lina Al-Jumaili	F	48	Plainfield Street
Narumi Hoketsu	F	26	Kemp Street
Luc Reyes	M	21	Park View Street
Traves Maley	M	73	Sun Court Street
Michel Sano	M	56	Saint Casimir Way
Francielle Ziolkowski	F	20	Rich Hood Avenue
Jordan Panizzon	M	88	Kneeland Street
Oludamola Girardet	F	70	Kirkland Place
Jiao Fasungova	F	25	Cordis Street
Libby McMillan	F	68	Fall Road
Attila Vicaut	M	77	Athens Street
Daigoro Johansson	M	34	Roswell Street
Marie Cuesta	F	57	Fossdale Road
Christine Heglund	F	86	Atwill Road
Evgeni Chen	M	67	Belnel Road
Nick Colwill	M	27	Halifax Street
Evi Junkrajang	F	22	Pond Circle
Yauhen Rafferty	M	65	Sierra Road
Carsten Puotiniemi	M	70	Riverside Place
Tatyana Sukno	F	85	D Street
Diguan Muff	M	16	Lubec Street
Erwin Emane	M	66	Ardmore Road
Santiago Klimov	M	89	Melbourne Street
Flor Magnini	F	83	Ormond Street
Laurence Hirata	M	41	Burnham Place
Kirsten Kinga	F	69	Sanger Street
Maria Johnson	F	69	Dunstable Road
Javier Volosova	M	81	Woodland Place
Ryan Adams	M	73	Spice Street
Louise Marton	F	54	Hathaway Street
Jessica Liu	F	21	Congreve Street
Emilie Jaeger	F	17	Decatur Street
Elania Hernandez	F	32	Newland Place
Erica Velez	F	85	Burnside Avenue
Alyssa Geikie	F	67	Jarvis Place
Andreas Soares	M	59	Robeson Street
Esmeral Gyurta	F	59	Canterbury Street
Evagelos Elaine	M	81	Saint Stephen Street
Annie Ali	F	38	Bennett Street
Hideki Liivamagi	M	70	Hillcrest Street
Viktoriia Glavnyk	F	31	Cheshire Street
Wendie Spearmon	F	19	Aldrich Street
Silvia Travica	F	31	Fairbanks Street
Rudi Deecke	M	54	Altacrest Road
Dariya Bratoev	F	80	Parmalee Street
Lubomir Frank	M	65	Rosselerin Road
Daniela Schaer	F	50	Minot Park
Tugba Brecciaroli	F	24	Harrison Avenue
Gergo Wijn	M	54	Primrose Street
Irina-Camelia Kim	F	87	Sycamore Street
Kame Boussoughou	M	69	East Third Street
Meredith Yu	F	59	Mulvey Street
Ondrej Fang	M	32	University Road
Mikhail Weel	M	53	Bentley Street
Francesco Boesen	M	60	Nancy Road
Candido Rumbenieks	M	22	Alban Street
Yasemin Voronova	F	90	Braemore Road
Kyle Chamberlain	M	81	Lyndhurst Street
Jose Pedersen	M	21	Range Road
Kana Manzano	F	19	Niles Street
Yuliya Shiratori	F	38	Call Street
Myong Fogarty	F	72	Ledgewood Road
Chia Bleasdale	F	78	Cleveland Place
Urska Fijalek	F	77	Evans Street
Sun Vidal	F	78	Dock Street
Amanda Li	F	55	Stearns Road
Guzel Castillo	F	77	Desmond Road
Ken Eom	M	58	Brookway Road
Mechiel Socha	M	61	Ferrin Street
Bianca Sekyrova	F	44	Olmstead Street
Derek Dancette	M	78	Homes Avenue
Tiago Gillow	M	24	Petrel Street
Vanesa Hitchon	F	80	Hartlawn Road
Seyeol Moon	M	34	Grampian Way
Franziska Gulnoi	F	30	Blakeslee Street
Nadzeya Allegrini	F	24	Brainerd Road
Nelcy Korshunov	F	27	Corona Street
Jean-Christophe Davenport	M	87	Oakcrest Road
Marija Vitus	F	86	Windsor Road
Tomasz Mun	M	16	Dacia Street
Amelie Svensson	F	19	Rainier Road
Ion Hutarovich	M	17	Ruggles Street
Kobe Rotaru	M	52	Caltha Road
George Gogoladze	M	80	Bentley Street
Julia Olsson	F	62	Trenton Street
Shota Michta	M	81	Degautier Way
Husayn Reuse	M	75	Oldfields Road
Dragos Stone	M	22	Glencliff Road
Valeriy Bluman	M	39	McClellan Highway
Dragos Nieto	M	52	Bushnell Street
Gundegmaa El-Sheryf	F	89	Kingsdale Street
Hanna Shaito	F	35	Cedarwood Road
Courtney Yankey	F	79	Rockdale Street
Marc Clair	M	78	Louis Terrace
Daniela Rajabi	F	23	Wood Avenue
Sandra Kszczot	F	24	Montgomery Street
Pedro Storey	M	24	Eagle Square
Aleksandr Pendrel	M	42	Bellaire Road
Mihnea Hamcho	M	85	Wright Street
Abiodun Horvath	F	65	Brock Street
Xavier Cox	M	59	Ernst Street
Christa Kvitova	F	17	Murdock Street
Adnane Srebotnik	M	80	Rich Street
James Meszaros	M	74	Lyne Road
Nuria Saenko	F	22	Stratton Street
Serhiy Bisharat	M	48	Doctor Mary Moore Beatty Circle
Andela Meauri	F	34	Margin Street
Richard Kim	M	40	Roswell Street
Oussama Payne	M	32	Rendall Road
Yoshimi Lu	F	78	Gordon Avenue
Valerie Battisti	F	16	Sweet Fern Terrace
Jun Podlesnyy	F	58	Marine Road
Nick O'farrell	M	29	Greendale Road
Carles Solesbury	M	78	Cambridgepark Drive
Luis Petkovic	M	50	Oxford Avenue
Tiago Lauric	M	69	Lanesville Terrace
Yasmin Brathwaite	F	18	Paris Court
Szymon Silva	M	83	Tibbetts Town Way
Sergey Wei	M	37	Chesterton Street
Mana Konyot	F	85	Lawnwood Place
Feng Barbachan	M	59	Radcliffe Road
Jehue Wild	M	47	Buchanan Road
Katya Baddeley	F	74	Porter Circle
Markiyan Monteiro	M	70	Dunbar Avenue
Giordan Hammer	M	81	Corinth Street
Donglun Borlee	F	74	Nassau Street
James Santoso	M	23	Camelia Avenue
Huajun Li	F	49	Cawfield Street
Oleh Chinnawong	M	79	Annavoy Street
Ramon Kirkham	M	74	Franconia Street
Madara Smith	F	73	Daniel Court
Monika Herman	F	44	Virgil Road
Sonja Parszczynski	F	86	Bolster Street
Nathan Freixa	M	69	William Day Boulevard
Valerie Penezic	F	35	Sorrento Street
Kaliese Sudol	F	35	Lawndale Terrace
Lucas Neal	M	78	Albert Street
Roderick Huang	M	41	Rufo Road
Craig Pijetlovic	M	55	Blackstone Street
Lina SCHIMAK	F	28	Knox Street
Kevin Zavala	M	84	Woodbourne Road
James McNeill	M	34	Farmington Road
Oleksiy Tan	M	66	Phillips Court
Teerawat Iersel	M	69	June Street
Traian Chen	M	28	Mildred Avenue
Mikaela Iwao	F	17	Trilling Way
Holder Lamont	M	56	Springer Street
Yuderqui Sahutoglu	F	57	Parkside Drive
Eric Ally	M	25	Cheever Court
Pawel Gibbons	M	40	Gold Star Road Court
Silvio Steryiou	M	76	Rodman Street
Viktor Lamdassem	M	41	Lee Hill Road
Leandro Asumnu	M	78	Parkson Street
Tandjigora Sobhi	M	25	Dartmouth Place
Nick Schodowski	M	53	Concord Avenue
Davit Nibali	M	35	Roseglen Road
Boniface Kanis	M	79	Lawson Place
Julia Jeon	F	32	Liszt Street
Donald Aleksic	M	54	Hooker Street
Lisbeth Savani	F	58	Intervale Street
Abdelhamid Cabrera	M	16	Oyster Bay Road
Irina Arias	F	50	Darling Street
Anderson Oh	M	58	Peters Street
Slobodan Meliakh	M	36	Charter Street
Mariana Inoue	F	88	Fayette Park
Abdelaziz Durant	M	28	Peoples Baptists Place
Anky Cheikh	F	20	Cedarwood Road
Harry Belete	M	86	Guernsey Street
Katarina Rogina	F	45	Fay Street
Tetyana Kvyatkovskyy	F	21	Donwood Terrace
Robert Moutoussamy	M	83	Hunter Street
Adam Hatsko	M	85	Matthew Street
Eric Sawa	M	79	Acton Street
Paula Pizzo	F	22	Seeanar Road
Marie-Louise Gunaydin	F	54	Ralwood Road
Hodei Phoenix	M	75	Tierney Street
Albert Barthel	M	60	Roxbury Street
Princesa Firdasari	F	77	Henrici Street
Nicole Golovkina	F	51	Beech Street
Claudia Ovinou	F	60	Buchanan Road
Alice Irabaruta	F	62	Blakemore Street
Saulius Won	M	69	Vershire Street
Maria Tegenkamp	F	39	Filomena Road
Jose Hernandez	M	62	Colberg Avenue
Oscar Palomo	M	18	Martin Street
Prince Zyl	M	16	Edwin Street
Luis Azcarraga	M	27	Hautevale Street
Sara Knowles	F	44	Crestwood Park
Danylo Aguiar	M	72	Paulman Circle
Mahe Ivashko	M	78	Paul Gore Street
Lena Miyama	F	16	Whitford Street
Eric Birca	M	59	Derne Street
Ricardo Kim	M	84	Appian Way
Omar Dumerc	M	19	Hadley Street
Keith Bindrich	M	53	Mascot Street
Kami Todorovic	F	50	Sanderson Place
Marie-Andree Dalby	F	82	Clearway Street
Hayden Seric	M	68	Cottage Court
Evgeny May-Treanor	M	32	Bower Street
Maria Smith	F	57	Vogel Street
Martina Windt	F	35	Westwind Road
Thomas Boggiatto	M	41	Montview Street
Oleksandr Schwarzkopf	M	47	Halford Road
Jo Dong	F	73	Bolton Street
Daria Schmid	F	65	Thomas Park
Martin Stankovic	M	36	East Springfield Street
Stepan Vecchi	M	42	Southeast Expressway
Elodie Arcioni	F	88	Magoun Street
Carlos Cebrian	M	90	Cragmere Terrace
Mike Bostock	M	45	Senders Court
Clarissa Skydan	F	19	Danube Street
Cesar Chen	M	37	Belfort Street
Binnaz Dehesa	F	40	Messinger Street
Artem Surgeloose	M	29	Appian Way
Peter Wagner	M	64	Corwin Street
Kei Truyens	M	86	Oldfields Road
Khamis Angeloni	M	52	Wellesley Park
Jie Tarasova	M	77	Ely Street
Linda Lotfi	F	21	Dewey Street
Jos Oliva	M	41	Waumbeck Street
Won Davison	M	22	Mansen Court
Yang Conti	M	34	Newcomb Street
Daniel Kouassi	M	44	Louisburg Square
Nicholas Warlow	M	58	Roberts Place
Leryn Henao	F	72	Alpha Road
Christina Petukhov	F	78	Gold Star Road Court
Raul Makanza	M	69	New Minton Street
Joel Simon	M	65	Bardwell Street
Younghui Karasek	F	58	Bates Street
Momotaro Khmyrova	M	77	Avondale Street
Pops Terlecki	M	60	Old Amory Street
Xavier Paul	M	49	Cogswell Avenue
James Wilson	M	73	Templeton Way
Marcelo Borchin	M	72	Mindoro Street
Mariano Danois	M	68	Ross Place
Daniel Huckle	M	78	Peak Hill Road
Hagos Hassler	M	46	Woodard Road
Constanze Sanchez	F	77	Saint James Avenue
Daria Palermo	F	53	Marmion Street
Paul Khadjibekov	M	22	Bennett Street
Iain Kossayev	M	80	Gladeside Avenue
Allison Musinschi	F	71	Worrell Street
Ivano Tetyukhin	M	18	Congress Street
Mihyun Dahlberg	F	41	Cottage Park Avenue
Zengyu Driel	F	89	Ceylon Street
Pietro Boukhima	M	50	Floral Place
Maung Cammareri	M	62	Mount Hope Street
Zsuzsanna Hodge	F	16	Ivanhoe Street
Kirsten Sandells	F	29	Montview Street
Darrel Khachatryan	M	68	Leighton Road
Chia Hilario	F	72	Sparhawk Street
Veronika Erichsen	F	31	Louders Lane
Tetyana Kolchanova	F	23	Napa Street
Boris Tunnicliffe	M	27	Kenrick Street
Ainhoa Melendez	F	44	Jewish War Veterans Drive
Maartje Fabian	F	22	Wabash Street
Melody Larose	F	61	Mariposa Street
Natalia Kim	F	44	High Road
Junior Gocic	M	90	Bunker Hill Court
Ryan Goss	M	67	Sharp Street
Jose Banks	M	72	Blackwell Street
Simona Skornyakov	F	78	Joy Place
Mojtaba Polyakov	M	66	Hallam Street
Becchara Pareja	F	38	Theodore Street
Kellie Leon	F	33	Park Avenue
Tamara Cafaro	F	32	Deer Street
Yukiko Nicolai	F	28	East Lenox Street
Vladislav Sivkova	M	73	Mayfair Street
Eugenie Uslupehlivan	F	24	Robken Road
Nicholas Stowell	M	47	Jo Anne Terrace
Alexandra Solja	F	81	Crispus Attucks Place
Elmir Sorribes	M	39	Heath Street
Martin Voulgarakis	M	18	Randlett Place
Jeremy Bowers	M	34	Dunstable Road
Daniel Marburg	M	58	Boyd Street
Camille Gao	M	19	Ivy Street
Todor Hernandez	M	87	Bennet Street
Juan Shankland	M	74	Priesing Street
Elizabeth Veljkovic	F	73	Cowing Street
Ahmed Gordon	M	54	Dalkeith Street
Anabelle Ismail	F	72	Forest Place
Olivera Lehtinen	F	67	Arion Street
Gianluca Schmidt	M	88	Hemman Street
Jonas Hutchins	M	87	Burmah Street
Ida Deak-Bardos	F	44	Churchill Avenue
Kurt Sano	M	38	Grover Avenue
Neil Kopp	M	74	Vaughan Avenue
Tina Hristova	F	77	Ramsdell Avenue
Julia Peng	F	72	Grantley Street
Stephanie Hansen	F	76	Traveler Street
Natalya Prorok	F	36	Floyd Street
Marta Pyatachenko	F	19	Soldiers Field Place
Tim Phillips	M	28	Portina Road
Kenneth Howden	M	20	East Fourth Street
Jessica Schwizer	F	52	Georgia Street
Jaime Ramadan	M	54	Josephine Street
Anna Lionetti	F	37	Gayland Street
Timm Augustyn	M	46	Corey Road
Amira Janoyan	F	30	Danbury Road
Katerina Nichols	F	37	Sanford Street
Joshua Faletic	M	88	Logan Street
Elias Koeverden	M	78	Bell Court
Coolboy Tian	M	78	Keenan Road
Olga Schofield	F	52	Mildred Hamilton Place
Guilherme Latt	M	77	Monponset Street
Petr Waterfield	M	82	Christopher Street
Crispin Terraza	M	16	Burrwood Road
Jemma Gabriele	F	70	Pine Ridge Road
Ligia Jefferies	F	62	Appian Way
Austra Sekyrova	F	17	Laurel Street
Aurelie Kirkham	F	87	Lawndale Terrace
Roel Garcia	M	61	Rich Hood Avenue
Primoz Aubameyang	M	39	Rockland Avenue
Christian Zambrano	M	65	Queensberry Street
Darryl Nikic	M	58	Dayton Street
Zbigniew Drozdovskaya	M	21	Aspinwall Road
Charles Zwarycz	M	82	Raynes Road
Nils Jurkevics	M	56	Ocean View Drive
Lesley Bithell	F	56	Halleck Street
Mario Daroueche	M	76	Sayward Place
Docus Muff	F	17	Westmoreland Street
Lankantien Kristensen	M	20	Miner Street
Jennifer Al-Azzawi	F	40	Tyler Court
Nazario Barrondo	M	85	Jeffries Street
Nicholas Nechita	M	40	Vallar Road
Tugce Vozakova	F	16	Rollins Court
Aldo Cerkovskis	M	89	Wadsworth Street
Viktor Michshuk	M	75	Norwell Street
Louise Karimov	F	87	Paulding Street
Yuki Adrian	F	21	Bellaire Road
Grace Williams	F	53	Whittier Place
Shalane Shiratori	F	87	Eustis Street
Maxime Paulo	M	81	Miner Street
Nazmi Patrikeev	M	66	Branchfield Street
Mihaela Toskic	F	39	Amesbury Street
Andy Maier	M	48	Newman Street
Dakota Ulrich	M	35	Grandee Street
Christopher Andersen	M	22	Columbia Road
Marina Neuenschwander	F	17	Merriam Street
Jose Solomon	M	64	Roseland Street
Alicia Samoilau	F	57	Platt Road
Lara Siegelaar	F	67	Elko Street
Arlene Douka	F	23	Philbrick Street
Suyeon Woo	F	84	Malcolm Road
Lucas Bankier	M	76	World Trade Center Road
Dobrivoje Mogawane	M	69	H Street
Miles Robertson	M	79	London Street
David Wang	M	35	Alleghany Street
Yue Birmingham	M	19	Averbuch Terrace
Bodin Prevolaraki	M	61	Westglow Street
Ratchanok Edwards	F	76	Guilford Street
Tom Anderson	M	38	Gracewook Park
Takamasa Kasa	M	74	East Fourth Street
Ivan Salakhova	M	38	Groveland Street
Konstadinos Troicki	M	56	Gridley Street
Layne Smith	M	47	Alkyris Road
Mario Boninfante	M	18	Cornwall Street
Nikolaus Milatz	M	79	Taylor Road
Mhairi French	F	41	Raymond Street
Hicham Hendershot	M	82	Emmet Street
Telma Andrunache	F	71	Gene Street
Ahed Alilovic	M	26	Rambler Road
Bingtian Jing	M	53	Jennett Avenue
Bunyami Valderrama	M	39	Linwood Square
Ioannis Tkach	M	18	Taylor Road
Asgeir Dzerkal	M	44	Island Street
Rafaela Moudatir	F	69	Woodlawn Street
Aretha Marino	F	71	Sturtevant Street
Zurabi Lunkuse	M	39	Alvah Kittredge Park
Denis Machado	M	42	Pelham Street
Afgan Mrvaljevic	M	62	Whittemore Avenue
Daria Shkurenev	F	44	Judson Street
Amer Lao	M	60	Goethe Street
Michael Yamamoto	M	54	Lynn Street
Sycerika Rabetsara	F	78	Coleman Street
Anouar Felix	M	40	Saint Peter Street
Nicholas Bithell	M	45	Saint Saveur Court
Hovhannes Gu	M	80	Pembroke Street
Dorde Pereira	M	17	Town Street
Claudia Butkevych	F	52	Burney Street
Michael Kraljev	M	79	Noah Street
Nazli Skipworth	F	39	Brookway Road
Robert Kraljev	M	48	Wesleyan Place
Lidija Usovich	F	59	Viking Street
Mario Agahozo	M	76	Noah Street
Christina Illarramendi	F	77	Saint Cyprians Place
Raul Baumrtova	M	19	Heathcote Street
Miki Zhang	F	39	Mansen Court
Vladimir Muda	M	67	Belton Street
Natasha Demydova	F	17	Hillock Street
Silvana Erickson	F	64	School Street Place
Joel Kammerichs	M	33	Stratton Street
Tom Mayol	M	73	Heldun Street
Daniel Silva	M	27	Addison Street
Romana Wu	F	83	Hinckley Street
Triyaningsih Choe	F	38	School Street
Doyler Ledaki	M	18	Matignon Road
Silviya Cesarini	F	62	Thornton Place
Denis McIntosh	M	26	Homestead Street
Marie Vourna	F	46	Wooddale Avenue
Heiki Outteridge	M	31	Eatonia Street
Michael Chang	M	55	Hanover Avenue
Sohsuke Ligeti	M	48	Newsome Park
Bojan Zhao	M	45	Ritchie Street
Lidiia Ng	F	77	Vogel Street
Abderrahime Arcioni	M	66	Weld Hill Street
Dmitriy Montano	M	89	Victoria Street
Ahmed Saladuha	M	41	Varick Road
Dong-Young Kim	M	81	Gardenside Street
Maureen Makanza	F	42	Line Street
Reine Arteaga	F	41	Old Dee Road
Soufiane Odumosu	M	22	Lawson Place
Yumi Buerge	F	72	Kenneth Street
Tamas Fredericks	M	26	K Street Place
Jordan Ndoumbe	M	53	Delnore Place
Belal Wang	M	47	Gore Street
James Takase	M	28	Walley Street
Tales Wu	M	54	Doane Street
Snjezana Hostetler	F	25	Northbourne Road
Andreas Stanning	M	77	Russell Street
Glenn Filandra	M	60	Chipman Street
Andrew Negrean	M	73	Raynes Road
Patrick Whalen	M	19	Fifield Street
Marcus Lahbabi	M	61	Sibley Court
Abouhalima Schauly	M	84	Souther Road
Ifeoma Lahbabi	F	82	Ditson Street
Chie Aigner	F	18	Chesterton Street
Vanessa Figes	F	68	Hildreth Street
Yoann Gentry	M	86	Hawley Street
Nevin Ikeda	F	90	Drumlin Road
Jakub Cristobal	M	28	Port Lane
Doris Wilke	F	52	Cliftondale Street
Ahmad Erceg	M	86	Cerdan Avenue
Michal Jakobsson	M	30	Blue Hill Avenue
Janis Hansen	M	34	Walford Way
Klaas Wykes	M	63	Saint Johns Road
Yahima Gojkovic	F	75	Sinclair Road
Jonathan Munoz	M	28	Rosaria Street
Andrey Osipova	M	18	Iowa Street
Meiyu Prasad	F	83	Windsor Road
Behdad Trowbridge	M	31	Hewes Street
Gil Warfe	F	75	Flagg Street
Hyleas Emanuel	F	50	Brookdale Street
Jimmy Akizu	M	22	Livermore Place
Noor Borzakovskiy	F	74	Miami Avenue
Ekaterina Sakaev	F	36	Farquhar Street
Peter Zyabkina	M	30	Heathcote Street
Yimeng Amaris	F	58	Bothwell Road
Leonardo Mitic	M	50	Webster Avenue
Marie Kozak	F	74	Ashfield Street
Floris Barros	M	20	Linden Avenue
Ioannis Burgaard	M	60	Tucker Street
Boniface Eichfeld	M	82	Brewster Street
Bebey Rodaki	F	25	Central Avenue
Kamilla Rietz	F	41	Percy Place
Victor Kondo	M	73	Wellington Place
Jose Overall	M	54	Winfield Street
Paul Cho	M	76	Coleman Street
Honami Kozhenkova	F	31	Macneil Way
Alexandra Sanchez	F	85	Sanborn Avenue
Lucie Kmetova	F	35	Olmstead Street
Robbert Kanerva	M	81	Wilmore Street
Heykel Liang	M	90	Norris Road
Radoslaw Sze	M	20	Castle Rock Street
Radhouane Cawthorn	M	34	Weld Hill Street
Chantae Bouqantar	F	34	Alveston Street
Sarra Moradi	F	52	Fairland Street
Evelin Niyazbekov	F	71	Thane Street
Hyok Maciulis	M	16	Kenton Road
Ned Scozzoli	M	47	Woodhaven Street
Pavel Lambarki	M	67	Hawthorn Street
Marina Murphy	F	52	Alaska Street
Elena Felix	F	35	Tilesboro Street
Olga Castano	F	58	Seaverns Avenue
Naomi Gattsiev	F	36	Fottler Road
Francesco Shigetomo	M	23	Elmhurst Street
Ed Papamihail	M	79	Huron Avenue
Annette Ouechtati	F	75	Intervale Street
Kien Mottram	M	33	Airport Road
Suyoung Rodrigues	M	27	Bushnell Street
Yann Simionescu	M	34	Presentation Road
Chia England	F	50	Marcella Street
Lisa Soeda	F	77	Maybrook Street
Nathan Zhang	M	40	Hillsboro Road
Betkili Kasold	M	83	Dresser Street
Olga Jon	F	52	Tai Tung Street
Arnaldo Abella	M	32	Pompeii Street
Nick Osagie	M	20	Weybosset Street
Gideon Kowal	M	51	Gustin Street
Maryna Le	F	74	Hartlawn Road
Ryosuke Ciglar	M	35	Phillips Court
Mclain Rakoczy	M	86	Webber Street
Ronald Kim	M	35	Culbert Street
Asgeir Lamble	M	33	Euclid Street
Maria Smid	F	74	Miles Street
Nicola Belikova	M	62	Hanover Avenue
Karen Avermaet	F	77	Pemberton Court
Jeremiah Dean	M	24	Ayles Road
Vincent Krasnov	M	73	Frisbie Place
Milos Pavoni	M	53	Standard Street
Masako Kuczko	F	57	Rosemont Street
Stephanie Chebbi	F	33	Salisbury Park
Holly Rogers	F	54	Nichols Place
Ahmed Annani	M	78	Thelma Road
Jinhui Brens	M	61	Dane Street
Seonkwan Cha	M	70	Queensberry Street
Brenda Hsu	F	21	Coronado Road
Egidio Kim	M	74	Egleston Street
Mercy Verlinden	F	58	Toppan Avenue
Paul Demare	M	63	Whitten Street
Lucia Price	F	21	Boston Wharf Road
Odile Green	F	85	Cerina Road
Zi McColgan	F	43	Mount Washington Way
Bohdan Kostelecky	M	53	Brighton Avenue
Lisa Yamamoto	F	35	Etna Street
Alexander Wei	M	55	Rowe Street
Cate Andrunache	F	25	Blossom Court
Olga Weel	F	19	Topeka Street
Conrad Ji	M	59	Lovejoy Place
Takao Vazquez	M	81	Carlford Road
Angela Palomo	F	59	Riverbank Place
Aksana Melian	F	86	Walton Street
Roberto Tsakonas	M	34	Toland Court
Mykyta Szpakowski	M	90	Farrington Avenue
Marcel Cainero	M	39	Latin Road
Claudia Platnitski	F	45	Boyd Street
Andile Kim	F	19	Saranac Street
Corine Kashirina	F	88	Stonehurst Street
Whaseung Maresova	M	55	New Haven Street
Simone Fesikov	M	70	Monponset Street
Justinas Wote	M	57	Alford Street
Sarah Martin	F	28	Mount Vernon Place
Meagen Spellerberg	F	58	Cornell Street
Marco Halkett	M	30	Nassau Street
Yana Takatani	F	43	Perrin Street
Guillermo Kim	M	46	Hall Street
Antti Stjepanovic	M	38	Stockton Street
Line Emanuel	F	90	Annapolis Street
Cesar Barseghyan	M	39	Kingston Street
Fineza Primorac	F	47	Centre Avenue
Dominic Seppala	M	39	Bethune Way
Vesna Rutter	F	18	Silver Street
Stany Spellerberg	M	28	Mount Washington Way
Silviya Elaisa	F	33	Tiverton Road
Daniele Kobrich	M	29	Wendell Place
Tatjana Henriquez	F	19	Rockdale Street
Bahar Deligiannis	F	53	Cottage Court
Peter Jang	M	84	Oriole Street
Brendan Mendy	M	19	Wiltshire Road
Donatien Lotfi	M	51	Bardwell Street
Ricardo Jones	M	47	Lyndhurst Street
Alicia Heintz	F	68	Haskell Street
Barbora Cotton	F	84	Como Road
Lynsey Hosni	F	84	Haul Road
Artur Truppa	M	50	Comet Place
Nicola Socko	F	36	Flagship Drive
Flor Jonas	F	62	Montvale Street
Megan Abdalla	F	41	Cemetery Road
Wing McMillan	M	83	Hilburn Place
Rosie Rapcewicz	F	18	Exeter Park
Seiya Railey	M	67	Farnham Street
Kelly-Ann Sundberg	F	81	Howell Street
Natalia Lippok	F	88	Wilmore Street
Matthew Chakhnashvili	M	25	Chetwynd Road
Naoya Bondarenko	M	40	Millers Lane
Agustin Wang	M	60	Hosmer Street
Suji Labani	F	74	Bulfinch Place
Danijel Grandal	M	89	Chetwynd Road
Geraldine Curtis	F	39	Woodledge Street
Rosie Fredricson	F	47	Exeter Park
Jeff Larson	M	23	Dalton Street
Robert Toumi	M	65	Ashton Place
Rasmus Rindom	M	53	Mark Street
Adam Costa	M	35	Melbourne Street
Joan Fudge	M	50	Fenno Street
Lauren Subotic	F	75	Neponset Valley Parkway
Christian Bidaoui	M	61	Westley Avenue
Krystal Pilypaitis	F	76	Coolidge Hill Road
Rafal Ri	M	90	Earnshaw Street
Uvis Fuchs	M	30	Jamaica Place
Audrey Pulgar	F	50	North Washington Street
Rudi Noga	M	79	Rowen Court
Judith Williams	F	23	Kilsyth Road
Aristeidis Leprevost	M	17	Drydock Avenue
Ak Valyukevich	M	20	Marginal Road
Carole Adams	F	49	Eastman Street
Miroslava Isakov	F	46	Hildreth Street
Kate Mata	F	87	Barrington Road
Nicole Shumak	F	25	Hotel Drive
Natalia Gatlin	F	90	Harvest Street
Michal Bazlen	M	48	Capen Place
Thiago Gu	M	65	Tarleton Road
Sheng Romdhane	M	82	Ledge Hill Road
Tina Lim	F	85	Stonley Road
James Aniello	M	21	Newbern Street
Brent Milczarek	M	64	Brucewood Road
Emmanuel Figere	M	61	Winthrop Street
Giulia Schwanitz	F	49	Locust Street
Ying Oliva	F	67	Page Street
Anthony Sunderland	M	68	Newell Street
Xing Djerisilo	F	71	Conry Crescent Street
Jamila Rodhe	F	21	Remington Street
Adnane Kim	M	27	Oakdale Square
Naomi Presciutti	F	80	Queen Street
Dalibor Vidal	M	88	Maple Avenue
Rachel Cash	F	25	Beauford Lane
Ava Silva	F	43	Morrison Court
Luka Begu	M	77	Cedrus Avenue
Nan Gionis	F	21	Richmond Street
Yoshiaki Athanasiadis	M	27	Kiernan Road
Sergio Calzada	M	48	North Washington Street
Sarah Ogimi	F	85	Caledonia Avenue
Nikolay Ahmed	M	88	Saville Street
Nikolina Otoshi	F	22	Hayward Place
Kristina Cerutti	F	42	Guest Street
Pavlos Nicolas	M	46	Gertrude Road
Denis Sidi	M	61	Griswold Street
Katharina Bartonickova	F	46	Wigglesworth Street
Tamir Fazekas	M	50	Dracut Street
Katarzyna Calabrese	F	24	Island Street
Maroi Tatham	F	88	Olmstead Street
Larissa Cortes	F	50	Noah Street
Andja Gabriele	F	31	Gates Street
Maximiliano Kim	M	18	Buick Street
Femke Gelana	F	65	Northbourne Road
Benjamin Kempas	M	73	Frisbie Place
Andile Li	F	27	Cranston Street
Marharyta Willmott	F	53	Tchapitoulas Street
Alexander Kosok	M	75	Willowwood Street
Emmanuel Montoya	M	60	Addison Street
Takahiro Rogers	M	82	Forest Hills Avenue
Rafail Maze	M	38	Old Road
Moana Xian	F	65	Duxbury Road
Ilaria Hu	F	60	Millstone Road
Joel Giordano	M	60	Belden Street
Chien-Ying Bompastor	F	66	Lorne Street
Barbara Ghayaza	F	62	Grover Avenue
Khalil Shi	M	23	Independence Drive
Erik Plouffe	M	87	Yeoman Street
Viktorya Harper	F	51	Liberty Place
Evgeniya Maneva	F	25	Elbow Street
Nikita Kirdyapkina	M	18	Broadway Terrace
Anita Goubel	F	53	Grimes Street
Szu-Yu Tait	F	68	Chamberlain Street
Anthony Kudlicka	M	59	Putnam Avenue
Paula Botia	F	85	Gibson Street
Nick Burrows	M	43	Wellington Place
Byunghee Filipe	F	56	Blackstone Street
Suzanne Silva	F	82	Hurley Street
Vignir Charter	M	77	Alger Street
Luis Li	M	67	Richview Street
Hiroshi Schuring	M	70	Fort Avenue Terrace
Ayman Barjaktarovic	M	43	Hilburn Place
Malin Zhang	F	48	Aspinwall Road
Daniel Green	M	86	Burwell Road
Adrianti Lloyd	F	19	Corona Street
Daniela Li	F	39	Alveston Street
Miyu Murray	F	31	River Street
Keith Beresnyeva	M	56	Cushman Road
Grainne Ross	F	27	Chipman Street
Sebastian Makela-Nummela	M	55	Edgebrook Road
Karin Myers	F	22	Charme Avenue
Aleksey Pahlevanyan	M	19	Undine Road
Tobias Cardoso	M	25	Glendon Street
Nedzad Braithwaite	M	43	Ditson Street
Kelly Povazsay	F	26	Wales Street
Lashinda Barton	F	70	Druid Street
Jantsan Spiler	M	72	Alleyne Street
Ashley Saramotins	M	60	Gillespies Lane
Alexis Diaz	M	65	Caspian Way
Jiyeon Iakovakis	F	90	Louisburg Square
Wen Ghayaza	F	39	Cemetery Road
Saori Kienhuis	F	36	Woodbrier Road
Joao Brecciaroli	M	42	Bournedale Road
Josefin Ma	F	86	Midland Street
Norayr Toth	M	29	Daly Street
Elena Belyakova	F	67	Vallaro Road
Evgeni McDonald	M	62	Lineham Court
Sau Jordan	M	78	Lawn Avenue
Charlotte Grechishnikova	F	36	Woodrow Avenue
Josephine Caleyron	F	75	Guild Street
Norbert Prokopenko	M	68	Glines Avenue
Ander Karakus	M	45	Toland Court
Kirani Oliva	M	82	Holworthy Place
Shehab Makhloufi	M	41	Braintree Street
Automne Moline	F	19	Don Street
Todd Istomin	M	77	Albany Street
Michael Tayama	M	66	White Street
Olivier Zhang	M	46	Greenbrier Street
Jessica Unger	F	30	Centre Avenue
Thi Kostadinov	F	33	Brookford Street
Angelo Uhl	M	86	Rand Street
Chu Willis	M	69	Tenean Street
Darryl Strebel	M	61	Dorchester Avenue
Jochen Koedooder	M	59	Hautevale Street
Myong Kozlov	F	64	Atkins Street
Natalie Coston	F	69	Kennedy Road
Vita Eckhardt	F	38	Dennison Street
David Rietz	M	21	Design Center Place
Jens Samsonov	M	75	Fallon Place
Nikola Zevina	M	25	Necco Court
Yi Daba	F	66	Richwood Street
Anzor Gu	M	77	Blackwell Street
Marcin Mihamle	M	27	Wenlock Road
Betkili Betts	M	72	Greenwich Court
Elisa Wang	F	69	Lansdowne Street
Jennifer Mogushkov	F	83	Ida Street
Chui Jacobsen	F	34	South Whitney Street
Chana Borges-Mendelblatt	F	62	Greenough Avenue
Silke Gallopin	F	63	Flavia Street
Nour Lobacevske	M	47	Jenkins Street
Kirsten Wang	F	52	Melvin Avenue
Michela Ayed	F	51	Melrose Street
Mathieu Graves	M	20	Popes Hill Street
Romulo Simanovich	M	61	Brookdale Street
Shijia Conway	F	39	Arvale Road
Yuko Gyurov	F	53	Barbara Street
Danyal Lefert	M	43	Wedmore Street
Radka Bahdanovich	F	86	Roach Street
Cecilia Clapcich	F	62	Cufflin Street
Marestella Viljoen	F	41	Branchfield Street
Jeroen Zhurauliou	M	55	Buckley Avenue
Luca Kipyegon	M	86	Evelyn Street
Christos Bryant	M	24	Cedarwood Road
Casey Santos	F	30	Moss Hill Road
Yuri Vieru	F	48	Valencia Road
Amine Kiss	M	78	Brighton Avenue
Christophe Radu	M	57	Ranley Road
Maximilian James	M	40	Dimock Street
Joel Scanlan	M	62	Newland Place
Dmitriy Halsted	M	51	Oneil Place
Mahmoud Mejia	M	17	Chatham Row
Connor Touzaint	M	83	Roswell Street
Yuderqui Mrak	F	32	Robert Street
Nahomi Jobodwana	F	25	Astoria Street
Karen Okruashvili	F	55	Alcott Street
Kristina Borges-Mendelblatt	F	29	Robey Street
Francine Semmler	F	57	Roxana Street
Hinkelien Mcmillan	F	60	Oliver Street
Viktor Bielecki	M	72	Arlington Avenue
Danyal Achara	M	17	Northampton Street
Yumeka Guo	F	57	Ainsley Street
Janne Bouw	F	63	Mount Washington Way
Manuela Syllabova	F	66	Gilman Street
Jefferson Nagy	M	83	Pleasanton Street
Bernhard Semmler	M	51	Breed Street
Ashley Johansson	F	83	Vinal Street
Rodrigo Santos	M	38	Lyford Street
Fabio Truppa	M	69	Rockview Place
Elia Gittens	M	49	Factory Street
Yu Chinnawong	F	31	Ballard Street
Hyelim Villaplana	F	77	Groom Street
Theodora Kemperman	F	71	Bexley Road
Orianica Lopez	F	83	Burns Court
Andres Gebremedhin	M	39	Algonquin Street
Mehdi Kovalenko	M	37	Boynton Street
Denis Matsenjwa	M	84	Sutton Street
Yulan Mohaupt	F	16	Ledgewood Road
Branden Cavela	M	55	Saxton Street
Nocawe Arevalo	F	70	Oakridge Street
Elena Schirrmeister	F	57	Prescott Place
Marcus Orban	M	61	Central Parking Access Road
Georgios Petrov	M	23	Corman Road
Josefa Zambrano	F	65	Mann Street
Carl Osipova	M	79	Wichita Terrace
Alina Ciobanu	F	26	Sturges Road
Adam Ruday	M	46	University Road
Clayton Schoettler	M	44	Holworthy Place
Salima Nakano	F	66	Patterson Street
Aziz Castaneda	M	68	Mount Washington Way
Mhairi Sommer	F	50	Arvale Road
Jin Walton	M	58	Savin Hill Avenue
Sonia Strombergs	F	40	Columbia Road
Shane Wu	M	35	Lawson Place
Toghrul Guenot	M	23	Saint William Street
Sonja Tinsley	F	76	W Harrington Memorial Way
Ioannis Cornet	M	18	Walworth Street
Enia Esterhuizen	F	51	Newkirk Street
Lorena Bosetti	F	25	Cortes Street
Jonathan Glanc	M	63	Parkway Road
Jan Sandig	M	61	Cuthbert Road
Caroline Ghislain	F	85	Gracewook Park
Joshua Azcarraga	M	72	Buchanan Road
Alexander Valois-Fortier	M	80	Pleasanton Street
Filippos Sinkevich	M	78	Haverhill Street
Mikalai Ali	M	78	Westview Street
Kynan Viljoen	M	51	Salem Street Avenue
Jamale Fu	M	80	Yawkey Way
Nicola Hosking	F	66	Cresto Terrace
Michael Sinia	M	55	Galty Avenue
Stephanie Comas	F	79	Cheshire Street
Samira Marcilloux	F	35	Gilman Street
Gaetane Desprat	F	33	Lynn Street
Florent Icho	M	58	Mahler Road
Kacper Phillips	M	24	Batchelder Street
Vladimir Dehghanabnavi	M	51	Bismarck Street
Ian Wilson	M	74	Vesper Street
Henk Schorn	M	69	Glendon Street
Maider Piccinini	F	79	Brigham Street
Zied Straume	M	26	Woodard Road
Bruno Williams	M	19	Henrici Street
Jamie Ahmed	M	63	Kenberma Road
Luisa Barros	F	57	Halleck Street
Juan Ananenka	M	51	Cardinal Medeiros Avenue
Phelan Poulsen	M	88	Tovar Street
Katharina Mizuochi	F	90	Riley Road
Grazielle Piekarska	F	20	Beechland Street
Wallace Mejri	M	39	Kristin Court
Harinelina Iakovenko	F	79	Kenilworth Street
Renee Na	F	74	Woodstock Avenue
Raissa Araya	F	89	Glendower Road
Elena Coster	F	81	Brooks Street
Hideki Federer	M	58	Armstrong Street
Ludwig Trias	M	66	Old Trail Road
Xiaoxu Cardoso	F	73	Elene Street
Gilberto Bergdich	M	31	Wellsmere Road
Darya Okruashvili	F	34	Frontenac Street
Michael Jr	M	75	Grady Court
Vera Sene	F	41	Newcastle Road
Fetra Shemarov	M	73	Academy Hill Road
Marian Atkinson	F	65	Locust Street
Min-Jae Piedade	M	30	Sargent Street
Thomas Shen	M	40	Nashua Street
Lauren KORSIZ	F	69	Clifford Street
Michael Caceres	M	67	Wolfe Street
Stefan Noonan	M	21	Danny Road
Asumi Colo	F	72	Richdale Avenue
Luis Lundgren	M	69	Favre Street
Andre Qin	M	29	Sanger Street
Grigoriy Zhang	M	65	Avila Road
Alex Adigun	F	60	Quaker Lane
David Amador	M	68	Wigglesworth Street
Lesle-Ann Tykhova	F	64	Maplewood Street
Holly Kim	F	49	Blandford Street
Marjo Janusaitis	F	28	Falkland Street
Jan-Di Ilias	F	57	Ainsworth Street
Merrill Kurek	M	85	Summer Street Place
Shinta Gong	F	57	Menton Street
Desiree Inglis	F	81	Payson Avenue
Roba Suvorau	M	52	Lewis Place
Hee-Tae Cebic	M	60	Aspinwall Road
Lucy Miller	F	17	Hester Street
Alexey Estes	M	32	Moville Street
Renal Boskovic	M	57	Powers Court
Simon Zordo	M	80	Riley Road
Lucy Perez	F	41	Estes Avenue
Aleksei Rouwendaal	M	28	Louis Terrace
Max Dutton	M	65	Cardington Street
El Toth	M	73	Hoyt Street
Kostiantyn Kim	M	40	Emily Street
Jongeun Kabush	F	16	Vogel Street
Franziska Nibali	F	31	Davern Avenue
Aleksandar Noujani	M	84	Rustlewood Road
Ilona Chamley-Watson	F	67	Freeport Street
Fatih Eisel	M	84	Guild Street
Luca Lee	M	58	Myrtlebank Avenue
Christopher Follmann	M	66	Bradeen Street
Ediz Raja	M	23	Pacific Street
Kristi Melo	F	74	Back Street
Connor Wagner	M	84	Gretter Road
Kristof Tranter	M	24	Craft Place
Jose Uhl	M	88	Greenbrier Street
Thiago Bruno	M	66	Havelock Street
Lulu Maguire	F	55	Albion Place
Nikolaus Svendsen	M	84	Cygnet Street
Toni Shevchenko	M	35	Lantern Lane
Svetlana Wang	F	80	Mercer Circle
Lapua Zeller	M	75	Saunders Street
Keri-anne KORSIZ	F	66	Lincoln Lane
Gabrielle Tikhomirova	F	26	Davenport Street
Florian Cinar	M	27	Moloney Street
Souad Haase	F	41	Taft Court
Vladislava Tichelt	F	57	Park Avenue
Ensar Taylor	M	58	Barna Road
Pajtim Pospisil	M	34	Crossman Street
Jill Magdy	F	27	Woodward Park Street
Larisa Kryvitski	F	71	Imbaro Road
Aoife Pyrek	F	82	Woodward Avenue
Toni Chambers	F	41	Summer Street Place
Na Anai	F	45	Parkway Road
Simon Matsuda	M	41	Ida Street
Spiridon Elkhedr	M	90	Roxton Street
Mai Csernoviczki	F	49	Van Winkle Street
Alex Nichols	M	52	Redfield Street
Diego Connor	M	64	Tanglewood Road
Robert Pereyra	M	71	Waldemar Avenue
Eloy Rasmussen	M	34	Cameron Avenue
Marcos Bond	M	38	Antwerp Street
Christos Minczer	M	88	Decatur Street
Seyha Balogh	F	79	Redgate Road
Ariane Nazarova	F	53	Embassy Road
Natallia Terzic	F	29	Tai Tung Street
Seongeun Magdanis	F	45	Stratton Street
Jakkrit Oldershaw	M	26	Lancaster Street
Diego Stojic	M	87	Monson Street
Yerkebulan Mitchell	M	58	Gibson Street
Belal Knowles	M	35	Green Street
David Al-Athba	M	88	Aspen Street
Jingbiao Cheon	M	40	Spurr Street
Silke Nam	F	66	Foch Street
Yusuf Riner	M	40	Salina Road
Rodrigo Craig	M	68	Myrtle Avenue
Robert Skrzypulec	M	54	Whitcomb Avenue
Maryam Denanyoh	F	32	Woodman Street
Louisa Horasan	F	54	Holborn Park
Suzana Teutenberg	F	68	Durant Street
Sanne Kuo	F	25	Greenbaum Street
Satoko Tegenkamp	F	38	Saco Street
Ioannis Martinez	M	84	Ridgewood Street
Jane Paonessa	F	18	G Street
Krisztian Ida	M	25	Plummer Place
Carolina Borman	F	36	Van Winkle Street
Casey Ouedraogo	F	61	Egleston Street
Georgia Raguib	F	56	Coniston Road
Hotaru Terceira	M	84	Willow Pond Road
Angel Pozdniakova	F	68	Briggs Place
Elena Dreesens	F	42	Fuller Place
Carsten Vukcevic	M	21	Meyer Court
Velichko Connor	M	45	Seaborn Street
Taimuraz Melis	M	20	Hodgon Terrace
Thomas Shmidt	M	50	School Street
Dallal Elgammal	F	16	Trident Street
Tianyi Wolde	M	39	Grozier Road
Yuhan Simonet	M	86	Evans Street
Michael Vasco	M	25	Hopewell Road
Kristina Walton	F	44	Conrad Street
Karl-Martin Adlington	M	68	Angell Street
Debbie Mohamed	F	28	Hemman Street
Irina Liu	F	68	Mount Ida Road
Hannah Rigaudo	F	67	Theodore Glynn Way
Alexander Frederiksen	M	29	Salman Street
Yasser Pannecoucke	M	81	Montclair Avenue
Shara Burgrova	F	71	New England Avenue
Mokhtar Dasaolu	M	17	Meehan Street
Shuang Salukvadze	F	59	May Street
Nataliya Gherman	F	19	Drury Road
Issa Persse	M	50	Lynde Street
Seungmin Trott	M	43	Regis Road
Lukasz Kovacs	M	78	Thornley Street
Caster Yumoto	F	50	Enfield Street
Ann-Marie Moffatt	F	43	Cliffmont Street
Pierre-Alexis Tom	M	27	Lubec Street
Germain Detti	M	24	Hampshire Street
Raphaelle Batum	F	79	Brainerd Road
Becky Wozniak	F	63	Fairmount Avenue
Luciano Ahmad	M	47	Veterans Of Foreign Wars Parkway
Arianna Tansai	F	42	Oakley Street
Marcel Gustafsson	M	62	Parkson Street
Evgeny Vives	M	50	Seckel Street
Sajjad Oriwol	M	89	Gertrude Road
Anne Hayes	F	81	Shelby Street
Justine Lavrentyev	F	48	Varick Road
Vitaliy Robson	M	27	Willard Street Court
Marion Reynolds	F	68	Havre Street
Rebecca Janic	F	40	Eastman Street
Damien Hejmej	M	41	Meridian Street
Albert Malki	M	28	Pelham Street
Matteo Gordeeva	M	37	Saint Johns Road
Rachel Morgachev	F	19	Kensington Park
Junggeu Regolo	M	57	Seaver Place
Tatiana Muncan	F	56	Park View Street
Antonija Shelley	F	30	Hamilton Road
Daniel Figueroa	M	68	Ralwood Road
Brad Ogimi	M	76	Pershing Road
Kirsty Urtans	F	90	Blake Street
Andy Olst	M	64	Eastbourne Street
Alia Luckwell	F	74	Drayton Avenue
Fabiola Alfaro	F	76	Peaceable Street
Antonia Medina	F	65	Dever Street
Natasa Bravo	F	60	Cedar Grove Street
Larisa Nagy	F	81	Groom Street
Yawei Fourie	F	48	Newman Street
Miraildes Azcarraga	F	72	Tuckerman Street
Karolina Brennauer	F	47	Camden Place
Maynor Lemos	M	27	Kingsley Street
Hassine Kutu-Akoi	M	75	Dewey Street
Oliver Grumier	M	52	Burnside Avenue
Serhiy Kang	M	62	Sacramento Place
Ioannis Mockenhaupt	M	19	Craigie Circle
Carmelo Diamond	M	35	Greenbrier Street
Ferdinand Clair	M	24	Hathaway Street
Filipe Ludwig	M	74	Florence Street
Bjorn Horakova	M	38	Harborside Drive
Aleksandr Holliday	M	43	Howitt Road
Sanya Dreesens	F	30	Haviland Street
Luis Grand	M	36	Searle Road
Irakli Dinu	M	44	McTernan Street
Maria Maslak	F	52	Saint Jude Terrace
Seoyeong Montoya	F	31	Alton Court
Concepcion Ovtcharov	F	31	Tudor Street
Melissa Jovanovic	F	21	Transit Street
Ilona Harrison	F	42	Monson Street
Milos Blazhevski	M	35	Fern Street
Kylie Ignaczak	F	40	Charles Road
Jianbo Janikowski	M	67	Faulkner Circle
Yasmin Soliman	F	56	Crowley Rogers Way
Adam Yumira	M	41	Athol Street
Bianca Al-Attiya	F	65	Gretter Road
Nguyen Mueller	F	17	Egan Way
Oiana Mirnyi	F	77	Line Street
Inaki Miller	M	81	Deerfield Street
Daria Fouhy	F	79	Chauncey Street
Mebrahtom Fields	M	40	Lake Shore Road
Gerco Abshero	M	38	Birchland Avenue
Kim Milczarek	F	16	Dimock Street
Igor Martin	M	59	Southmere Road
Fernanda Purchase	F	32	Longmeadow Street
Christopher Leroy	M	48	Dayton Street
Kieran Bayaraa	M	42	Webley Street
Yuri Florence	F	73	Hallwood Road
Georgios Kostiw	M	45	Jewett Street
Hassan Bouw	M	66	Dalrymple Street
Hanna Mironcic	F	81	Market Street
Mercy Pietrzak	F	22	Drummond Place
Petr Vicaut	M	29	Pelham Street
Marcelo Filippov	M	59	Curtis Street
Monique Pohrebnyak	F	76	Woodrow Avenue
Shuai Huang	F	67	Foch Street
Jolanta Siriteanu	F	82	Verona Street
Viktoriya Aguirregaray	F	86	Storey Place
Brijesh Kim	M	73	Unity Court
Jaime Bruno	M	28	Kineo Street
Ramon Eom	M	88	Grew Hill Road
Gal Pascual	M	18	Larch Place
Claire Murphy	F	19	Willers Street
Pedro Kim	M	66	Johnston Road
Ludwig Pishchalnikov	M	26	Weeks Avenue
Blessing Alamirew	F	74	Tappan Street
Wanner Teshale	M	59	Peter Parley Road
Damir Hendershot	M	49	Salman Street
Jianlian Burgers	M	50	Magazine Court
Nuttapong Bewley	M	61	Morton Street
Miryam Dunnes	F	68	Centola Street
Michelle Andersen	F	66	Priesing Street
Mario Husseiny	M	72	Viking Street
Sergio Ivankovic	M	43	Highland Avenue
Mink Hernandez	M	47	Court House Way
Sarolta Bakare	F	44	Hewlett Street
Evgeny Schoneborn	M	74	Taylor Road
Ryoko Goubel	F	59	Surryhill Lane
Pablo Pereyra	M	25	Van Brunt Street
Henna Pertile	F	28	Gartland Street
Tatiana Naby	F	29	Van Ness Street
Amy Prevot	F	42	Norcross Place
Irina Song	F	18	Vincent Road
Amanda Tateno	F	23	Nashua Street
Rebecca Gao	F	75	Palermo Street
Daniel Shipilova	M	31	Greenville Street
Audrey Silva	F	21	Filomena Road
Julia Lepke	F	74	Alicia Road
Kyle Marcus	M	16	Manila Avenue
Fabian Knight	M	83	Jefferson Street
Erick Fedoriva	M	50	Dow Road
Marie Gonzalez	F	35	Wendell Place
Aniko Logan	F	78	Waldo Terrace
Jan Merzougui	M	53	Alleghany Street
Danilo Chabbey	M	88	Cheever Court
Kateryna Mitrea	F	42	Neponset Avenue
Cleopatra Ryder	F	69	Transportation Way
Louise Mrisho	F	21	Welton Road
Emilia Sintes	F	45	Brookledge Street
Patrik Brown	M	52	Carlson Circle
Ivan Edelman	M	47	Fulda Street
Abdihakem Li	M	64	Larkhill Road
Shiho Brens	F	69	Garrison Street
Linyin Manojlovic	M	33	Macullar Road
Rosa Mozgov	F	17	Atkins Street
Rene Chen	M	45	Morrow Road
Julia Dovgodko	F	54	Freeland Street
Dane Chintoan	M	36	Locke Street
Nedzad Crisp	M	30	Pompeii Street
Egor Ferreira	M	47	William Jackson Avenue
Matthias Mendes	M	48	Alaric Street
Mariela Mortelette	F	53	Lewiston Street
Daniel Hayashi	M	25	Esther Road
Eunice Zairov	F	73	Saint Gregory Street
Sangjin Adeoye	M	57	Train Street
Arnaud Stremler	M	70	Brinton Street
Gauthier Bindrich	M	24	Basto Terrace
Marquinhos Samara	M	82	Blair Place
Russell Verdasco	M	18	Battery Street
Jason Hostetler	M	79	River Street Bridge
Anis Boninfante	M	24	Verdun Street
Frano Mendelblatt	M	71	Jenkins Street
Rachel Zaikov	F	89	Archdale Road
Simone Brathwaite	M	37	Bishop R Allen Drive
Cassidy Jelcic	F	49	Eastern States Road
Dominic Matkowski	M	26	Tarleton Road
Mathieu Pigot	M	56	Chittick Road
Oliver Wu	M	88	Ransom Road
Rosie Aydemir	F	55	Warren Avenue
Shane Fischer	M	25	Deacon Street
Nguyen Calderon	F	81	Wenlock Road
Midori Seraphin	M	39	Raleigh Street
Iuliana Costa	F	74	Morrill Street
Hae-Ran Garcia	F	50	Catawba Street
Susan Bluman	F	22	Pomeroy Street
Andrew Gallardo	M	45	Arvale Road
Matthew Ri	M	49	Davenport Street
Tarek Luis	M	48	Briarcliff Terrace
Carolina Wang	F	43	Theriault Court
Artur Darien	M	26	Crockett Avenue
Chelsea Thiele	F	24	Grover Avenue
Alan Cerches	M	19	Northbourne Road
Nicola Kovalev	F	72	Woodside Avenue
Jessica Mcgivern	F	80	Bearse Avenue
Andrew Liu	M	26	Wilna Court
Guzel Mangold	F	35	Lochstead Avenue
Francis Thiele	M	54	Glendale Street
Tejay Dobrowolski	M	54	Central Avenue
Axel Cook	M	37	Russell Street
Chantae Matuhin	F	65	Melrose Street
Onan Weale	M	72	Stinson Court
Nikita Papadopoulos	M	16	Howitt Road
Jonas James	M	67	Selwyn Street
Fanny Castillo	F	85	Wenlock Road
Matthias Ekimov	M	85	Vale Court
Kerri Paszek	F	21	Short Road
Christina Tavares	F	33	Morton Street
Michael Gigli	M	46	Mead Street
Marios Gelpi	M	38	Campanella Way
Olesya Nielsen	F	76	Lorna Road
Justine Ferrari	F	44	Ernst Street
Mahmoud Hession	M	53	Thomas Park
Ahmed Magdanis	M	19	Jewish War Veterans Drive
Yevgeniy Degtyarev	M	18	Mountain Avenue
Gabor Palies	M	21	Marbury Terrace
Alberto Pedersen	M	53	River Street Bridge
Ana Rasheed	F	29	Clare Avenue
Ikhtiyor Goss	M	53	Fossdale Road
Olesya Silnov	F	84	Shelby Street
David Junior	M	88	Amboy Street
Noemi Sabirkhouzine	F	52	Carmen Street
Zoltan Puusta	M	55	Errol Street
Yura Straume	F	22	East Fifth Street
Miroslava Williams	F	42	Fair Oaks Street
Kristel Henzell	F	51	Fruit Street
Yulia Hostetler	F	49	Eldridge Road
Dmitriy Liang	M	34	Kimball Lane
Edino Fuchs	M	42	William Jackson Avenue
Georgia Tipsarevic	F	17	Greenough Avenue
Yvonne Vitus	F	56	Wichita Terrace
Ahreum Ecuele	F	35	Moraine Street
Kanako Zhang	F	23	Matignon Road
Guillaume Colle	M	86	Murray Avenue
Vladimir Benedetti	M	67	Highgate Street
Adam Sasaki	M	88	Wyoming Street
Francesca Rowbotham	F	88	Oakman Street
Daniele Nurmukhambetova	M	89	Elbert Street
Tilak Costa	M	28	Washington Street Place
Bediha Janovic	F	30	Lee Hill Road
Veronica Robert-Michon	F	22	Lanesville Terrace
Kelis Wurzel	F	51	Van Winkle Street
Thomas Jurkowski	M	56	Cenacle Road
Leisel James	F	41	Boutwell Street
Jan Steiner	M	78	Gordon Avenue
Hagos Kempas	M	26	Tudor Street
Kristina Munro	F	36	Fairway Street
Jan Peilbet	M	58	Lafield Street
Miljan Henderson	M	68	Grace Court
Yusuke Kuziutina	M	62	Saint Jude Terrace
Yoshimi Szucs	F	58	Wyola Place
Lauren Burch	F	25	Arthur Street
Elco Williams	M	22	Fawndale Road
Habibollah Smith	M	78	Stoneholm Street
Raghd Ikehata	F	41	Fairland Street
Zamandosi Flood	F	90	Adella Place
Aleksandar Fasungova	M	57	Chesbrough Road
Reza Hoovels	M	44	Balmoral Park
Lisa Mendibaev	F	22	Pearl Street
Glenn Ouedraogo	M	32	Frontage Road
Dimitri Kim	M	44	East Lenox Street
Anouar Worrack	M	31	Evelyn Street
Peter Suzuki	M	22	Back Street
Tinne Campriani	F	36	Saint Andrew Road
Gediminas Whitehurst	M	60	Bushnell Street
Yeon Santos	M	37	Woodfield Street
Lok Al-Athba	F	64	Seven Pine Street
Robyn Levy	F	74	Maryland Street
Cy Malzahn	M	71	Manthorne Road
Amy Schipper	F	46	Doane Street
Mario Rivas	M	79	Mayhew Street
Betsi Semmler	F	70	Latin Road
Zara Jung	F	34	Josephine Street
Saul Huddle	M	57	Peter Parley Road
Aya Thunebro	F	83	Middlesex Street
Joseph Lin	M	87	Rogers Park Avenue
Michal Krsmanovic	M	65	Harry Agganis Way
Ni Robinson-Baker	F	88	Caton Street
Jiao Grzybowska	F	35	Circuit Street
Barry Utanga	M	59	Seattle Street
Greta Apolonia	F	17	Truman Parkway
Shiwen Huang	F	87	Brock Street
Florian Drouin	M	19	Scribner Road
Christopher Philippe	M	45	Fresh Pond Lane
Amer Reyes	M	65	Sexton Court
Hiroki Klokov	M	68	Woolson Street
Jinling Golovkina	F	67	Monterey Avenue
Helena Drmic	F	64	Vandine Street
Daniel Blazhevski	M	70	Brenton Street
Sarra Bainbridge	F	69	Rockvale Circle
Kai Eraliev	M	29	Durant Street
Jack Lochte	M	60	Strathmore Road
Micheen Zhang	F	32	Acton Street
Simon Walker	M	34	Regan Road
Yage Bruno	F	65	Westminster Avenue
Liam Weber	M	33	Stedman Street
Alexander Mccabe	M	25	Navarre Street
Elisa Phillip	F	41	Waterford Street
Ludivine Williams	F	83	Munroe Street
Arben Mikhaylov	M	72	Oleander Street
Laura Barry	F	47	Spice Street
Simona Sauveplane	F	53	Farrar Avenue
Viktor Rangelova	M	24	East Eighth Street
Maksim Acuff	M	56	Crossman Street
Mark Major-Kubik	M	76	Saco Street
Annamaria Crothers	F	67	Barrett Avenue
Zigismunds Winther	M	71	Arrow Street
Irina Kaddouri	F	35	Cogswell Avenue
Lauren Pereira	F	53	Keenan Road
Lauri Ihle	M	56	Bowman Street
Martin Howard	M	25	Creighton Street
Galina Zalomir	F	49	Cresto Terrace
Franziska Huang	F	19	Moloney Street
Maria Knowles	F	20	Scouting Way
Yifang Jang	F	31	Avalon Road
Ana Seifert	F	71	Eutaw Street
Raul Izotov	M	54	Tchapitoulas Street
Katherine Luca	F	38	Islington Street
Craig Csima	M	87	List Place
Mariusz Yang	M	64	Lamartine Place
Laetitia Yamauchi	F	56	High Road
Rebecca Ayglon	F	32	Marvin Place
Joachim Mironcic	M	40	Iron Street
Haojie Fernandez	M	31	Rowley Street
Dmytro Golding	M	73	Shanley Street
Lauryn Bae	F	70	Middle Street
Maksim Muttai	M	84	Wade Street
Thomas Doder	M	36	Quint Avenue
Simone Moreau	F	21	Jenkins Street
Kimberley Obiang	F	84	Staniford Street
Michal Chatzitheodorou	M	68	Warner Street
Richard Han	M	54	Boyden Street
Ahmed Harrison	M	67	Cornelius Way
Dae-Nam Dunkley-Smith	M	51	Burr Street
Pawel Tobin	M	67	Harvey Street
Fabio Morkov	M	46	Rupert Street
Andrei Randall	M	25	Kingston Street
Jaime HIMONAS	M	80	Livingstone Street
John Keefe	M	43	Rozella Street
Jimmy Wyngard	M	53	Locksley Street
Anderson Guo	M	66	Horadan Way
Sholpan Draudvila	F	29	Adamson Street
Molly Cerdeira	F	49	Buckley Avenue
Ahmed Korzeniowski	M	48	Eleanor Street
Laura Dundar	F	19	Shafter Street
Aline Peters	F	72	River Street
Justin Mandir	M	87	Viking Street
Maria Sheikhau	F	62	Davidson Avenue
Zachary Podryadova	M	43	Hurlbut Street
Ander Cronje	M	74	Kardon Road
Ivan D'almeida	M	78	Ashfield Street
Francisca Mocsai	F	41	Wesleyan Place
Jessica O'Connor	F	44	Charter Street
Hui Ahmed	F	87	Grady Court
Mona Parsonage	F	34	Greylock Road
Konstadinos Houghton	M	35	Lanesville Terrace
Yi Mansouri	F	65	Newhall Place
Feiyi Zavadsky	M	87	Parsons Street
Szu-Yu Hove	F	64	Drydock Avenue
Iurii Parker	M	55	Newcomb Street
Yuri Querin	F	80	Maynard Place
Michelle Kirilenko	F	16	Vine Avenue
Therese Thornton	F	30	Maple Avenue
Aleksandrs Castellani	M	76	Fottler Road
Louisa Hazer	F	47	Monastery Road
Sam Scott-Arruda	M	89	Hautevale Street
Lee Veneva-Mateeva	M	75	Garden Lane
Hyobi Erokhin	F	87	Holworthy Place
Martin Mozgalova	M	90	Cotuit Street
Liliana Mullin	F	83	Rowe Street
Franck Gemo	M	70	Hopewell Road
Barna Vican	M	84	Rexford Street
Ibrahim Seoud	M	82	Pomona Avenue
Aly Hilton	M	27	Pinedale Road
Olena Krsmanovic	F	58	Newmarket Square
Kate Florence	F	59	Chauncy Street
Leah Driel	F	58	Dennis Street
Anton Aguilar	M	60	Gertrude Road
Elena Falgowski	F	32	Whitfield Street
Rokas Stosur	M	42	Danny Road
Ole Hardy	M	72	Ronan Street
Grant Watkins	M	47	Saratoga Street
Yevgeniy Hemthon	M	88	Lockwood Street
Marcel Goodison	M	17	Santuit Street
Sergej Ayalew	M	82	Putnam Avenue
Norma Tomic	F	43	Englewood Avenue
Ursula Ward	F	37	Floral Place
Daniela Rapp	F	81	Glenmore Street
Georgina Issanova	F	52	Quinn Way
Patrick Kiyotake	M	62	Walton Street
Jere Guidea	M	61	Hemlock Road
Orianica Semenya	F	16	Clipper Ship Lane
Jefferson He	M	36	Hanson Street
Barbara Shakes-Drayton	F	85	Payson Avenue
Hannah Knioua	F	79	Bell Court
Alex Gregory	M	52	Moody Street
Anthony Gruda	M	79	Morrow Road
Gilles Jang	M	68	Custom House Street
Iain McNeill	M	53	Northern Avenue
Natalia Klapalova	F	50	Keenan Road
Ivan Hollstein	M	66	Woodward Park Street
Mary Ogar	F	19	Hillsboro Road
Priscilla Chitu	F	62	Ardent Street
Matias Hosnyanszky	M	16	Marlow Terrace
Daniel Cooke	M	85	Pinefield Lane
Mateusz Mendoza	M	82	Crowley Rogers Way
Serhiy Robinson	M	22	Providence Street
Jur Gebremeskel	M	63	Oakcrest Road
Silviya Saholinirina	F	44	Weitz Street
Louis Maneza	M	30	Wallingford Road
Tania Silva	F	69	Gardenside Street
Pietro Warfe	M	65	Brannon Harris Way
Alberto Vidal	M	40	National Street
Muhamad Sanders	M	90	Morris Street
Maria Emmons	F	21	Fresno Street
Maria Steiner	F	40	Parley Avenue
Kianoush Skrimov	M	73	Saville Street
Marcia Amri	F	39	Gertrude Road
Jing Monteiro	F	71	Harvard Avenue
Francine Zhang	F	69	Eastern States Road
Sandra Siemionowski	F	89	Elmont Street
Matthew Helgesson	M	83	Atkins Street
Marry Gille	F	45	Julian Street
Christen Gonzalez	F	88	Arlington Avenue
Grigor Suuto	M	70	Galty Avenue
Jin Pontifex	F	83	Constitution Road
Rachelle Kanerva	F	18	Mullins Court
Petr Schiavone	M	87	Alleghany Street
Tyler Payet	M	57	Orton Marotta Way
Birhan Ryan	M	46	Avon Place
Cristiane Forciniti	F	87	Binford Street
Gemma Milburn	F	90	Middlesex Street
Simona Milthaler	F	89	Orne Street
Mateusz Yi	M	46	President Road
Elena Frolov	F	48	Hurley Street
Matthias Mugula	M	27	Brookdale Street
Heather Billings	F	38	Culbert Street
Thierry Ortiz	M	27	Max Avenue
Dong-Young Garcia	M	86	Sudbury Street
Ravil Azou	M	72	Birchcroft Road
Yakhyo Hfaiedh	M	75	Hunter Street
Thais Mihalache	F	33	Wadleigh Place
Juliane Yanit	F	20	Sunderland Street
Morgan Akkar	M	20	Bicknell Street
Gonzalo Gough	M	56	Blueview Circle
Dzhamal Barry	M	38	Crawford Street
Zhongrong Xu	M	81	Brookline Avenue
Hassan Nichols	M	29	Moraine Street
Johana Yauhleuskaya	F	70	Tuttle Street
Taehee Moberg	M	79	Mascot Street
Sabina Williams	F	75	Longwood Avenue
Nicola Chan	F	26	Saint Mary Road
Xueying Hillmann	F	33	Perthshire Road
Atsushi Djerisilo	M	52	Turtle Pond Parkway
Jorge Wilhelm	M	74	Willow Pond Road
Tanyaporn Mohamed	F	67	Cambria Street
Tomomi Spratt	F	34	Mansur Street
Seiichiro Almagro	M	47	Seckel Street
Maria Ito	F	36	Vineland Street
Chia-Jung Sanneh	F	57	Emerson Place
Michael Bekele	M	72	Field Street
Jiri Yazdani	M	68	Brookline Avenue
DeeDee Dumitrescu-Lazar	F	86	Mother Julia Road
Julie Ovchinnikovs	F	80	Mount Ash Road
Neil Priddy	M	81	Ashland Avenue
Anett Kamaruddin	F	62	Fellows Street
Sergii Chamley-Watson	M	71	Parker Street
Hui Akutsu	F	79	H Street
Paul Casey	M	87	Woodville Park
Zinaida Birarelli	F	25	Lyall Street
Svetlana Dieke	F	35	Broad Canal Street
Maureen Silva	F	20	Rogers Street
Evelyn Magdy	F	47	Dennison Street
Keon Mcculloch	M	87	Branch Street
Brady Mendonca	M	59	Camden Place
Tim Csonka	M	53	Fernboro Street
Katarina Taea	F	37	Gore Street Place
Olivier Pontifex	M	23	Dwight Street
Leah Aleksic	F	58	Belmore Terrace
Jiaxing Bespalova	F	18	Smith Field Road
Margaux Glanc	F	36	Donwood Terrace
Lauren Boukouvala	F	52	Shabazz Way
Juan Gregson	M	81	Bronx Road
Agnese Abdelrahman	F	44	Day Square
Darvis Vogt	M	62	Montello Street
Dominique Hall	F	43	Mossdale Road
Vincent Hartig	M	43	Westwind Road
Jong Stoney	M	18	Cardington Street
Nanne Maree	M	56	Wenham Street
Gaetane Partridge	F	36	Aldrich Street
Anna Scozzoli	F	33	Berkeley Place
Cornel Ding	M	33	Maida Terrace
Maksim Idrobo	M	35	F Street
Tanyaporn Mazuryk	F	28	Emery Road
Yeon-Koung Nilsson	F	70	Leyland Street
Galen Kirpulyanskyy	M	87	Kneeland Street
Alhaji Dugrenier	M	85	Life Street
Vladimir Desravine	M	76	Melrose Street
Natalya Kim	F	74	Tracton Avenue
Valeria Marino	F	67	Hubbard Avenue
Hakim Svennerstal	M	63	Agnes Avenue
Apti Mccormack	M	83	Lena Terrace
Ionut Kalovics	M	61	Tappan Street
Magnus Jauhari	M	45	Alward Road
Jess Gesink	F	86	Old Road
Tiffany Zeid	F	16	Newacre Road
Faith Kim	F	45	Chelsea Street
Thuraia Voytekhovich	F	87	Maffa Way
Yuderqui Purevjav	F	61	Eric Street
Christophe Tanii	M	58	Crossman Street
Yige Lamoen	F	20	Bay Street
Marcia Khubbieva	F	80	Lynde Street
Samantha Grankin	F	52	Eliot Bridge
Yang Fraser	F	59	Carroll Street
Jose Liu	M	83	Marginal Road
Pajtim Ahmadov	M	56	Westbrook Street
Lina Cabral	F	83	Walker Court
Aneta Harrysson	F	39	Harvard Avenue
Melissa Hsieh	F	47	Pinckney Street
Erasmus Perez	M	88	Pleasant Avenue
Marko Baltacha	M	68	Glenway Street
Sviatlana Zucchetti	F	43	Highgate Street
Sergey Dahlberg	M	30	Tonawanda Street
Nadezda Lee	F	35	Deaconess Road
Chien-Ying Fraser-Holmes	F	48	Raven Street
Ondrej Houssaye	M	50	Forbes Street
Chunlei Balazs	F	36	Orient Avenue
Shuang Cabrera	F	82	Arcola Street
Ju Isner	M	65	Westford Place
Dongho Jensen	M	59	New Haven Street
Eddie Sigueni	M	47	Burlington Avenue
Prince Sloma	M	72	Somerville Avenue
Ivana Fajdek	F	68	Ethel Street
Yun-Hee Karagoz	F	41	Langley Road
Alice Riou	F	72	Quarley Road
Lauren Jiang	F	71	Thornley Street
Jiao Faulds	F	28	Scouting Way
Chloe Cariolou	F	87	Powell Street
Jeannette Prokopiev	F	57	Thurston Street
Julian Antosova	M	85	Holden Street
Natallia Sidi	F	65	Saint John Street
Alex Zhang	M	41	Patterson Street
Gretta Aramburu	F	39	Kennedy Road
Akzhurek Whitty	M	40	Waldren Road
Jan Ryakhov	M	59	D Street
Aman Al-Jumaili	M	59	Silloway Street
Peter Garcia	M	78	Barbara Street
Teresa Jing	F	58	Burns Court
Severine Gibson	F	64	Emmett Place
Jorge Ford	M	33	Dresser Street
Oscar Mitic	M	87	Soley Street
Concepcion Rosique	F	90	Rockmount Street
Luciano Telde	M	76	Bremen Street
Mohamed Koo	M	84	Crispus Attucks Place
Vladimir Rodriguez	M	63	Daly Street
Bashir Liu	M	81	Goodway Road
Concepcion Vasilevskis	F	63	Fowler Street
Stephan Grankin	M	68	Church Street
Horacio Klizan	M	85	Braintree Street
Anqi Hernandez	F	34	Pershing Road
Baorong Mir	F	63	Westbrook Street
Alistair Baccaille	M	86	Rock Avenue
Sergio Thompson	M	52	Ernest Avenue
Clara Jeong	F	45	Willow Pond Road
Moon Caille	M	43	Agawam Street
Paula Zhudina	F	33	Ronald Street
Klara Gubarev	F	55	Spring Road
Rita Sanchez	F	76	Saint Mary Road
Alejandro Pratley	M	85	Kerwin Street
Yumi Gray	F	36	Adrian Street
Georgie Santos	F	49	Wollaston Terrace
Saralee Wilson	F	40	Trinity Place
Xia Lansink	F	47	Blenford Road
Filipp Nguyen	M	87	Laredo Street
Marco Dries	M	76	Spring Park Avenue
Alexander Jiang	M	88	Blanche Street
Ahmad Schipper	M	28	Fisher Avenue
Lauryn Fujio	F	67	Kenilworth Street
Ferenc Aydarski	M	32	Wensley Street
Maxim Fredricson	M	78	Knight Street
Kyeongae Franco	F	60	Primrose Street
Jolanta Vives	F	17	Causeway Street
Jeroen Torstensson	M	58	Vaughan Avenue
Sungmin Drebot	M	37	Payne Street
Ned Vieyra	M	86	Duncan Street
Soslan Fernandez	M	20	Hazelmere Road
Kerron Lee	F	24	Friendship Road
Daniele Babaryka	M	48	Howitt Road
Mie Hall	F	38	Damon Place
Marielis Findlay	F	33	Guilford Street
David Jeong	M	37	Dunning Way
Athina Kula	F	89	Hartland Street
Nick Hauss	M	21	Blossom Court
Zana Tregaro	F	64	Burgess Street
Mary Tomashova	F	49	Parker Street
Tarek Takahira	M	81	Talbot Avenue
Aleksey Garcia	M	47	Tebroc Street
Andrew Meliz	M	90	Verndale Street
Claudia Zhang	F	65	Abbot Street
Roba Torokhtiy	M	86	Chappie Street
Tom Mcculloch	M	19	Telford Street
George Matsuda	M	90	Saratoga Street
Jesus Williams	M	33	Anselm Terrace
Omar Canitez	M	87	Brookline Avenue
Kyung Ebanega	M	33	Sussex Street
Theodora Conway	F	57	Humes Road
Melanie Westbrook	F	29	Toledo Terrace
Lorena Ginn	F	64	Wolfe Street
Chuyoung Sokolowska	M	70	Keystone Street
Arantxa Kalnins	F	54	Northbourne Road
Beth Moorwood	F	65	Parker Hill Avenue
Sehryne Akrout	F	25	Nancia Street
Alex Hosnyanszky	M	20	Cambridgepark Drive
Omar Osl	M	78	Bournedale Road
Hernan Kizaki	M	26	Albion Place
Katya Lehtinen	F	17	Smart Street
Sophie Aliyev	F	39	Westford Place
Sergey Elgharably	M	52	Park Lane Drive
Simona Mennigen	F	17	Mallard Avenue
Fabio Figes	M	35	Magoun Street
Mitch Trafton	M	67	Sturbridge Street
Jan Garcia	M	49	Glendon Street
Lars Barsoe	M	30	Dever Street
Paul Almeida	M	64	Cambridge Parkway
Katerina Riccobelli	F	63	Barnes Avenue
Anton Hayytbaeva	M	66	Lucerne Street
Iveta Blagojevic	F	87	Westmoor Circle
Un Avramova	F	64	Queensberry Street
Celeste Leroy	F	43	Newman Street
Manabu Medvedev	M	66	Ranley Road
Emma Frica	F	35	Round Hill Street
Yuliya Signate	F	69	Winfield Street
Samantha Zavadova	F	23	Woolson Street
Nevin Hurtis	F	24	Ledge Hill Road
David Male	M	21	Lillian Street
Taine Clarke	M	45	Caspar Street
Isabellah Fredricson	F	73	Beverly Street
Mariaesthela O'connor	F	90	Dixfield Street
Emmanuel Willis	M	65	Goddard Street
Kacper Coster	M	37	Bangor Road
Ibrahim Ikuesan	M	73	Huntoon Street
Ashleigh Aissou	F	36	De Soto Road
Kathleen Simonet	F	89	Langdon Street
Hajung Cardona	F	75	Dunbar Avenue
Sabrina Abily	F	84	Cranston Street
Mamorallo Holzer	F	78	Brentwood Street
Ashley Maclean	M	17	Atherton Avenue
Hyeonwoo Rolin	M	55	Robinson Street
Oscar Bultheel	M	61	Bedford Street
Attila Tafatatha	M	58	Webber Street
Samuel Somogyi	M	23	Tafts Avenue
Greggmar Benassi	M	90	Northdale Road
Claudia Eshuis	F	65	Wilrose Street
Jayde Madarasz	F	31	Catherine Street
Davit Asano	M	81	Beryl Street
Roman Strajhar	M	83	Commonwealth Avenue
Francois Achour	M	83	Libbey Street
Eduardo Collins	M	39	Egleston Street
Tosin Mckendry	M	52	Proctor Street
Clara Fraser-Holmes	F	80	Alban Street
Irakli Wang	M	21	Eatonia Street
Ming-Huang Araujo	M	62	Lothian Road
Niki Grangeon	F	88	Hastings Avenue
Marcel Roelandts	M	34	Treadway Road
Raman Nikolaev	M	69	Owencroft Road
Vincent Brize	M	27	Veterans Of Foreign Wars Parkway
Sinead McHale	F	45	Palace Road
Georgios Antal	M	87	Burrell Street
Lucy Burmistrova	F	25	Court House Way
Ranomi Sorokins	F	20	Gerry Street
Kayono Nikitina	F	24	Lingard Street
Patricia Guo	F	35	Arborway Terrace
Alejandra Ndong	F	37	Sawyer Avenue
Ferenc Savsek	M	76	Matthews Street
Etenesh Liptak	F	24	Clapp Street
Iosif Wang	M	71	I Street
Dylan Espinosa	M	80	Westwind Road
Geoffrey Plotyczer	M	24	Dewey Street
Ikhtiyor Kamikawa	M	83	Asticou Road
Georgi Hernandez	M	82	Stinson Court
Giovani Alflaij	M	21	Organ Park Street
Jens Lavrentyev	M	68	Ellard Road
Lindsay Savard	F	23	Levant Street
Macarena Jorge	F	70	Blakeslee Street
Samira Grubisic	F	89	Court Square
Guzel Kahlefeldt	F	20	Gayland Street
Bilel Lazuka	M	41	Island Street
Danijel Paderina	M	82	Munson Street
Michelle Gueye	F	16	Harbor Street
Eva Mocsai	F	28	Paisley Park
Kenenisa Anim	M	69	Eldon Street
Sven Contreras	M	55	Tobin Bridge
Kozue Martinez	F	30	Ivy Street
Katie Park	F	49	Fayston Street
Jean Andrunache	M	87	Taber Street
Sacha Qin	M	75	Fensmere Road
Mohamed Steele	M	89	Hall Street
Niki Klimesova	M	74	Lindall Place
Boleslav Schwank	M	33	Pappas Way
Bishindee Wilcox	F	28	Athol Street
Marius-Vasile Biezen	M	78	Camp Road
Luka Mutai	M	22	Falcon Street
Annekatrin Cha	F	52	Walk Hill Street
Mirko Hemthon	M	62	Duxbury Road
Alena Noa	F	42	Broadway Terrace
James Haghi	M	26	Gray Gardens East
Mohammad Goderie	M	79	Hamilton Road
Lucia O'malley	F	32	Bournedale Road
Sonia Williams	F	79	Norwood Street
Nicholas Howden	M	58	Millet Street
Emma Cheng	F	85	Moulton Street
Guido Kanerva	M	57	Crest Street
Thiago Rosso	M	78	Hull Street
Abiodun Rogers	F	90	Hartwell Street
Steven Ma	M	39	Water Street
Rizlen Errigo	F	75	Norfolk Avenue
Joshua Capkova	M	43	Cranston Street
Sanja Silva	F	73	Catherine Street
Silvia Chaika	F	69	Rock Hill Road
Alejandro Abdi	M	45	Pheasant Street
Rahman Carboncini	M	46	Jennett Avenue
Janice Glasnovic	F	36	Wiltshire Road
Anja Barzola	F	16	Doncaster Street
Magdalena Siladi	F	85	Harrison Avenue
Roxanne Trott	F	90	Traill Street
Andrey Si	M	30	Province Street
Drasko Choi	M	81	Dunlap Street
Irada Velthooven	F	34	Fairway Street
Job Maestri	M	27	Kirkland Place
Maria Clapcich	F	29	Camden Place
Giovanna Krantz	F	21	Broad Street
Laura Boyce	F	89	Higgins Street
Rokas Karasev	M	56	Oakridge Street
Viktoriia Madico	F	21	McDonough Court
Jan Berg	M	22	Pinewood Street
Silvia Ioneticu	F	86	Halifax Street
Sally Fuamatu	F	67	Livermore Place
Pierre-Alexis Lika	M	38	Alder Street
Louisa Tomas	F	39	Pomeroy Street
Nazli Demare	F	26	Rutherford Avenue
Sophie Ghasemi	F	86	Tiverton Road
Olha Lewis-Smallwood	F	39	Aberdeen Avenue
Assan Jeune	M	66	Tappan Street
Marianna Ford	F	46	Nelson Street
Christopher Shubenkov	M	68	Eugene Circle
Andrey Kim	M	85	Gertrude Road
Louis Zhou	M	28	Walton Street
Arnaud Gonzalez	M	65	Selma Street
Melanie Disney-May	F	57	Albright Street
Irina Treimanis	F	42	Emelia Terrace
Antje Feiteira	F	55	Jeffries Street
Fabrizio Lanigan-O'keeffe	M	59	Portland Street
Lotta Tereshchuk	F	64	Cemetery Road
Georgia Garcia	F	61	Halsey Road
Svetlana Ikeda	F	24	Bellevue Hill Road
Clement Starovic	M	30	Spice Street
Juan Kim	M	51	Second New Way
Adelinde Mangold	F	44	Waldo Terrace
Marlene Cabrera	F	43	Edith Street
Yugo Sesum	M	47	Gordon Avenue
Alberto Han	M	49	Duval Street
David Shvedova	M	16	Aspen Street
Arkady Pryiemka	M	24	Short Road
Nyam-Ochir Yauhleuskaya	M	29	Blakemore Street
Josefin Lamdassem	F	51	Braintree Street
Vincent Darnel	M	24	Mccraw Street
Panagiotis Watanabe	M	68	Sellers Street
Michael Houvenaghel	M	79	Ernest Avenue
Kerron Saedeleer	F	31	Pinckney Street
Vasyl Malaquias	M	52	Trapelo Street
Esteban Storck	M	18	Jacob Street
Omar Kempas	M	74	Branch Street
Marcin Pechanova	M	19	Hallowell Street
Aleksandar Abian	M	48	Glenmore Street
Christian Machavariani	M	76	Providence Street
Giacomo Koski	M	37	Braeburn Road
Caroline Barac	F	46	Donald Road
Yennifer Haydar	M	83	Franklin Court
Beth Mazuryk	F	74	Round Hill Street
Toea Liptak	F	29	Wachusett Street
David Rossi	M	66	Woolson Street
Marius Davies	M	59	Round Hill Street
Aida Ganiel	F	46	Rexhame Street
Daouda Martelli	M	51	Selma Street
Artur Munkhbaatar	M	21	Glencoe Street
Qingfeng Li	M	69	Ipswich Place
Rozle Johansson	M	25	Neponset Avenue
Arianna Lauro	F	68	Turner Street
Sviatlana Yang	F	75	Ambrose Street
Francisco Bartoch	M	87	Lorenzo Street
Emilio Williams	M	71	Alaska Street
Amor Fukushi	M	29	Toppan Avenue
Neisha Liang	F	79	Elmira Street
Dieter Kocaturk	M	25	Fordham Road
Yoo Prendes	M	36	Everdean Street
Nastassia Zalsky	F	75	Kalyda Park
Robert Mothersille	M	74	Grimes Street
Ryosuke Kiplagat	M	33	Tai Tung Street
Gojko Lee	M	79	Gates Street
Peter Malloy	M	30	Electric Avenue
Radu Opeloge	M	34	Crossman Street
Jaleleddine Achola	M	45	Education Street
Sebastien Pryiemka	M	16	Miami Avenue
Farrah Sdiri	F	69	Dane Street
Akzhurek Lahbabi	M	43	Wessex Street
Melek Toth	F	29	Fordham Road
Igor Turner	M	42	Reed Street Court
Ardo Mastyanina	M	75	Comet Place
Khairul Steffen	M	41	Frisbie Place
Ibragim Cerutti	M	56	Chesterton Street
Sarah Markussen	F	65	Union Avenue
Caster Gong	F	36	Maryland Street
Lucy Vitting	F	46	Bates Street
Marie Kim	F	31	Hardy Street
Tatyana Bernado	F	57	Oliver Street
Rosario Rulon	F	36	Galileo Galilei Way
Vasyl Geijer	M	90	Saint Joseph Street
Anderson Novozhylova	M	27	Walbridge Street
Danielle Edlund	F	35	Southwood Street
Martin Amb	M	86	Red Pine Road
Lianne Schuring	F	47	Hillock Street
Phuttharaksa Signate	F	22	Turquoise Way
Al Shaw	M	27	Manton Terrace
Yun Luo	M	85	Cottage Park Avenue
Norbert Nicolas	M	58	Buckley Avenue
Kyung Granstrom	M	16	Victory Road
Sarah Zaidi	F	61	Mapes Street
Lijiao Fumic	F	17	Rockmount Street
Madias Jeffery	F	65	Perabo Terrace
Teerawat Gueye	M	21	Patterson Street
Marcel Mathewson	M	62	Clermont Street
Indre Golas	F	19	Camelia Avenue
Bostjan Sprunger	M	25	Westville Street
Jonelle Ayim	F	64	Sparrow Street
Wenyi Kikuchi	F	74	Welland Road
Matiss Rosa	M	61	Harbor Point Boulevard
Miguel Skujyte	M	55	Montfern Avenue
Mohsen Pyatachenko	M	39	Esten Street
Katerina Wang	F	37	Parmalee Street
Emma Pink	F	48	Fayston Street
Carlien Meeuw	F	25	Desmond Road
Kevin Jeptoo	M	50	Valenti Way
Maria Ro	F	53	Menton Street
Felix Pessoa	M	19	Hatch Street
Aron Pilhofer	M	16	Claybourne Street
Fionnuala Sameshima	F	77	Arrow Street
Lei Wojtkowiak	M	17	Greenwich Court
Drew Aly	M	23	Spring Valley Road
Marek Mathieu	M	47	Ellard Road
Carl Nielsen	M	22	Hawes Street
Anastasiya Jebbour	F	34	Tuttle Street
Kariem Claudino	M	77	Gene Street
Donglun Nhlapo	F	60	Stonecrest Road
Lori Jacobsen	F	30	Southeast Expressway
Artur Talbot	M	81	Minden Street
Liam Edelman	M	56	L Street
Anastasiya Miller	F	22	Alton Court
Nicholas Sazanavets	M	67	Lombard Street
Ash Buckland	F	50	Lennoco Road
Benjamin Bussaglia	M	19	Cedarcrest Circle
Miho Franco	F	63	Euclid Street
Hanna-Maria Bluman	F	74	Fairlane Road
Michael Vasic	M	51	Southbound Frontage Road
Sandeep Karayel	M	59	Gillespies Lane
Francisco Sinia	M	18	Montvale Street
Pape Kantarci	M	47	Vogel Street
Michael Onguene	M	68	Evergreen Street
Yukari Tanaka	F	29	Cambria Street
Shinichi Grasu	M	89	Henrici Street
Elania Ryan	F	32	Ford Street
El-Sayed Prodius	M	85	Mansen Court
Travis Ponsana	M	37	Mount Hood Road
Hyun Strebel	M	61	Meehan Street
Henriette Bayramov	F	40	Havre Street
Martin Strebel	M	25	Marston Street
Henna Newell	F	46	Galty Avenue
Thomas Grubbstrom	M	26	Clarence Street
Timea Nus	F	35	Franclaire Drive
Julian Hjelmer	M	40	Leicester Street
Gergely Dorokhova	M	42	Oakwood Street
Nicholas Morgan	M	54	Napier Park
Donglun Rohner	F	29	Edson Street
Stephanie Piasecki	F	90	James Shea Circle
Shunsuke Erakovic	M	55	Maryland Street
Simon Franco	M	33	Gaston Street
Fiona Arroyo	F	87	Brier Road
Andres Liu	M	58	Violet Street
Kasper Schops	M	68	Pembroke Street
Sonja Ide	F	60	Cheriton Road
Sara Malave	F	79	Catawba Street
Laura Jung	F	53	Harcourt Street
Dave Scott	M	29	Rupert Street
Peter Sloma	M	80	Wayburn Road
Joyce Kuehner	F	45	Alvah Kittredge Park
Teklemariam Fabre	M	83	Pompeii Street
Zohar Iwashimizu	M	16	Kelton Street
Anthony Mizutani	M	66	Flint Place
Tetsuya Tereshchuk	M	16	Lorna Road
Aldo Nicolas	M	40	Corbet Street
Zouhair Jambozorg	M	27	Alleghany Street
Robert Adamiec	M	69	Jess Street
Tate Zucchetti	M	41	Eugenia Road
Vasilisa Jeong	F	61	Stratton Street
Asier Filonyuk	M	82	Michelangelo Street
Guan Cabrera	M	37	Wellington Hill Street
Evgenia Kechrid	F	80	McKone Street
Austra Bauza	F	54	Deering Road
Urska Anacharsis	F	61	Orchard Park Street
Alex Li	F	51	Emmet Street
Sergiu Merrien	M	23	Cheshire Street
Matthieu Wang	M	42	Ames Street
Sverre Dawkins	M	68	Eleanor Street
Aniko Ahmed	F	26	Suncrest Road
Wenjun Juszczak	F	43	Beech Street
Wesley Meftah	M	58	Waterford Street
Andrea Williams	M	27	Callahan Place
Craig Furey	M	63	Haverford Street
Alexey Fukumi	M	53	Wilbert Circle
Kenichi Densham	M	73	Alvah Kittredge Park
Maneepong Lin	M	58	Granville Road
Margarita Ariza	F	78	Zamora Court
David Rahimi	M	70	Rindge Avenue
Andrija Peker	M	20	Congress Street
Yukie Louis	F	59	Gerry Street
Pascal Deligiannis	M	53	Mercer Circle
Rodrigo Kibet	M	45	Rutherford Avenue
Hyok Martinez	M	73	Pelton Street
Niki Garcia	F	81	Horan Way
Tino Henze	M	26	Arborway
Robert Knowles	M	27	Worcester Square
Steve Mun	M	71	Dodge Road
Anabel Kal	F	25	Cedar Lane Way
Guilherme Zhang	M	35	Melcher Street
Steven Kostelecky	M	83	Maxfield Street
Alexey Friedrich	M	82	Marlow Terrace
Roberta Callahan	F	82	Fawndale Road
Rebecca Reid-Ross	F	29	East Seventh Street
Woroud Baroukh	F	70	F Street
Jamol Perez	M	45	Burns Court
Irene Soloniaina	F	51	Jette Court
Paul Mndaweni	M	48	Homer Avenue
Lijie Fowles	F	81	Ronan Street
Roland Berg	M	44	Soldiers Field Place
Britta Jenner	F	36	Rich Street
Lance Maksimovic	M	39	Hardwick Street
Sayed Savitskaya	M	60	Ballard Street
Phathana Maier	M	65	Huckins Street
Jamy Malzahn	F	82	Delore Circle
Kristina Sokhiev	F	78	Brewster Street
Saheed Durkovic	M	61	Pinecliff Road
Juan Jeon	M	33	Starbird Avenue
Simone Mackay	M	45	Drydock Avenue
Keri-anne Kauter	F	17	Cardinal Medeiros Avenue
Rand Gilot	F	67	Aspinwall Road
Hongmei Filippov	F	80	Vesta Road
Maja Orban	F	66	Hollander Street
Miranda Mulligan	F	48	Wentworth Street
Iaroslav Jakabos	M	72	Rogers Park Avenue
Giulia Edwards	F	61	Theodore Glynn Way
Jennifer Kim	F	60	Chapman Place
Francesco Branza	M	82	Champney Street
Francois Spanovic	M	51	Trescott Street
Leith Clear	M	73	South Whitney Street
Nicolas Aranguiz	M	86	Saco Street
Ioulietta Assefa	F	70	Nashua Street
Inmara Castro	F	76	Greenbaum Street
Hichem Belomoyna	M	36	Beauford Lane
Azusa Richter	F	56	Harold Park
Lynsey Bailey	F	49	Goodenough Street
Amina Arusaar	F	40	Wayne Street
Hreidar Godelli	M	55	Clermont Street
Steven Stevens	M	35	Westmount Avenue
Adrien Kleibrink	M	90	Kemble Place
Victor Ganeev	M	35	Wainwright Street
Yanfei Nono	F	65	Ashley Street
Hannah Lozano	F	58	Wait Street
Lisa Atlason	F	48	Reed Street Court
Natalia Alfaro	F	32	Manion Road
Rene Antosova	M	46	Bakersfield Street
Heshan Harrysson	M	48	Essex Street
Daeyoong Louis	M	30	Arborview Road
Tremaine Evans	M	50	Hestia Park
Ola Almeida	F	60	Newbury Street
Esref Moiseev	M	54	Etna Street
Steven Schlanger	M	27	Rowena Street
Sarah Delpopolo	F	27	Hathaway Street
Jie Gebremariam	M	64	Reading Street
Shao Watt	F	35	Claremont Park
Tina Teutenberg	F	79	Rockvale Circle
Christopher Armstrong	M	25	Ring Road
Joel Csernoviczki	M	79	Lubec Street
William Polavder	M	72	Orton Morotta Way
Vera Silva	F	90	Whitcomb Avenue
Andrea Reilly	F	39	Dennis Street
Malin Manie	F	89	Warren Avenue
Tapio Gorman	M	25	Willard Street Court
Luis Elhawary	M	77	Appleton Road
Carlos Hall	M	41	Saint Peter Street
Mohamed Fanchette	M	69	Louis D Brown Way
Shana Halsall	F	58	Seven Pine Street
Iuliia Kim	F	40	Colchester Street
Adrienne Buntic	F	27	Elba Terrace
Yuliya Furukawa	F	35	Watson Street
Jamie Kinderis	M	29	Glen Lane
Jozef Nolan	M	43	Fernwood Road
Shelley Kondratyeva	F	26	Rugg Road
Artem Daluzyan	M	21	Ravenna Road
Majda Biehl	F	43	Otis Place
Volha Mahfizur	F	35	Emery Road
Stefana Cotti	F	51	Harcourt Street
Janko Ochoa	M	28	Nottingham Street
Sibusiso Yudin	M	48	Concord Avenue
Boglarka Vacenovska	F	29	Oakmere Street
Atthaphon Starovic	M	76	Ransom Road
Ivan Caballero	M	75	Call Street
Seen Flores	F	28	Aldworth Street
Chia Jensen	F	51	Meyer Court
Jong Dunlop-Barrett	M	54	Haydn Street
Pavlos Castro	M	44	Burney Street
Ali Watanabe	M	59	Roach Street
Amber Mattsson	F	28	Boxford Terrace
Paula Darzi	F	61	Frontenac Street
Tim Lehtinen	M	82	Ted Williams Tunnel
Nada Filipe	F	61	Marshfield Street
Robert Gan	M	44	Old Amory Street
Chun Yamaleu	F	40	Norman Street
Lei Estrada	F	33	Banfield Avenue
Feliciano Tecau	M	73	Stonehurst Street
Kyung Kaifuchi	F	90	Wharton Court
Marton Coetzee	M	25	Trask Street
Mattia Sanchez	M	19	Westley Avenue
Jinhui Rouhou	M	45	Mclean Place
Savva Ford	F	24	Camelia Avenue
Kilakone D'elia	M	74	Derne Street
Henrique Naef	M	19	Embassy Road
Andrew Ekame	M	30	Lochland Road
Sadio Chouiref	M	31	Oneil Place
Danylo Bond-Williams	M	73	East Second Street
Ivan Abdusalomov	M	51	Quarley Road
Aleksandr Konate	M	47	Hillview Avenue
Natalia Manaudou	F	82	Larchmont Street
Anderson Page	M	58	Sheridan Street
Guojie Timofeyeva	M	67	Torpie Street
Jinzhe Trinquier	M	39	Deer Street
Dilshod Thiney	M	72	Lee Burbank Highway
Methkal Grabich	M	16	Breck Avenue
Ellen Liivamagi	F	17	Oak Hill Avenue
Fabienne Bouw	F	21	Courtland Road
Dominic Rowe	M	84	Oliva Road
Dorothy Kim	F	81	Ipswich Place
Yanmei Matkowski	F	79	Glendale Street
Norma Aanholt	F	46	Ledge Hill Road
Ana Lowe	F	78	Malvern Street
Elena Rezende	F	17	Porter Circle
Grzegorz Tipsarevic	M	46	Longfellow Bridge
Alena Davis	F	58	Poplar Road
Pascal Leroy	M	19	Sunset Hill Road
Brigitte Foster-Hylton	F	60	Front Street
Krisztina Guri	F	30	Princeton Street
Cristina Goh	F	38	Dunster Road
Emmanuel Mukasheva	M	29	Calvin Place
Suhrob Jacob	M	28	Lochstead Avenue
Jean-Christophe Pompey	M	45	Manor Street
Benjamin Bilici	M	31	Field Street
Hao Fukumoto	F	81	Jackson Circle
Nelson Accambray	M	81	Sea View Avenue
Andisiwe Graham	F	33	Stanley Street
Mervyn Mcmahon	M	61	Griggs Place
Wirimai Enders	M	74	Bradeen Street
Martyna Baraka	F	41	Carpenter Street
Daniel Verdasco	M	35	Stanhope Street
Viktor Pineda	M	42	Oliva Road
Giulia Freden	F	40	Crestway Road
Taufik Toksoy	M	17	Knox Street
Irina Tukiet	F	89	Morse Street
Christopher Rouhou	M	80	Brookview Street
Chia-Ying Djokovic	F	57	Mariposa Street
Andre Takatani	M	25	Stoneholm Street
Marie Unsworth	F	90	Dingley Place
Jayme Suarez	M	66	Arborcrest Terrace
Automne Driel	F	69	Traill Street
Duhaeng Agren	M	78	Mill Street
Jana Rendon	F	87	Crawford Street
Navruz Kliger	M	87	Centervale Park
Yadira Psarra	F	82	Woodley Avenue
Ndiatte Brown	M	46	Main Street
Karsten Bidaryan	M	83	Rich Street
Marius-Vasile Sidi	M	42	Rosebery Road
Alice Tukhtachev	F	52	Mount Bowdoin Terrace
Maro Jiang	M	73	Hovey Avenue
Kame Vesely	M	20	Bennet Street
Gabriela Terblanche	F	30	Hollander Street
Myung Kim	M	66	Eric Street
Jesus Barrett	M	90	East Lenox Street
Christine Bonk	F	52	Oriole Street
Patricia Edward	F	46	Trenton Street
Sonia Berens	F	76	Sunset Avenue
Ahmed Chammartin	M	22	Haley Street
Shane Lauric	M	31	Fletcher Street
Glenn Rezola	M	83	Jerome Street
Irene Morath	F	53	Bernard Street
Bojana Erakovic	F	78	Almont Street
Nilson Belmadani	M	78	Marden Avenue
Bo Titenis	F	87	Heldun Street
Ka Ma	M	41	Cheney Street
Komeil Menchov	M	72	Wayne Street
Viorica Schwarzkopf	F	30	Storrow Drive
Juan Lovric	M	30	Fayette Park
Dede Trinquier	F	84	Hadassah Way
Annamaria Yi	F	54	Hillside Avenue
Aneta Cardoso	F	42	New Frontage Road North
Harry Brunstrom	M	89	Claremont Park
Dino Aicardi	M	24	Woodstock Avenue
Laetitia Cornelissen	F	31	Braintree Street
Blair Wei	M	20	Larkhill Road
Lisa Nagay	F	51	Floral Place
Toshiyuki Bernier	M	48	Pleasanton Street
Marcin Desta	M	19	Garner Road
Anaso Booth	M	24	Ashford Street
Kami Shabanov	F	80	Benton Street
Jose Ishizu	M	66	Hillis Road
David Zabolotnaya	M	23	Don Street
Krystian Ruiz	M	55	Kershaw Road
Akemi Cerdeira	F	32	Woodman Street
Elena Clark	F	20	Willard Street Court
Nuno Rajabi	M	88	Schuyler Street
Gulnara Deeva	F	26	Fargo Street
Kyle Baddeley	M	55	Seminole Street
Patricia Scott	F	71	Fernboro Street
Rachelle Roleder	F	41	Pinedale Road
Michael Hultzer	M	69	Asheville Road
Betkili Khaibulaev	M	84	Catenaccia Way
Damian Woods	M	38	Sellers Street
Edwige Henderson	F	33	Glenellen Road
Lieuwe Lim	M	50	Cambridgeside Place
Joseph Bartley	M	80	Farragut Road
Caroline Kirdyapkina	F	40	Spurr Street
Borja Rodriguez	M	58	Plymouth Street
Judith Zhu	F	44	Blagden Street
Elodie Muniain	F	66	Granger Street
Bianca Coleman	F	70	Grant Place
Dorothy Abdvali	F	36	Elwell Road
Kieran Mota	M	57	Dow Road
Richard Cremer	M	56	Cherry Court
Moon Eltrabily	M	71	Morey Road
Shane Gemmell	M	22	Kenilworth Street
Lyubov Gunnewijk	F	17	Teragram Street
Elania Rodionova	F	47	Clayton Street
Nina Sornoza	F	32	Eastmont Road
Neuso Luini	M	54	Thetford Avenue
Fantu Nikcevic	F	34	Tetlow Street
Lyudmyla Dilmukhamedov	F	64	Fall Road
Rhett Donato	M	78	Belmore Terrace
Kunzang Kim	F	71	Paine Street
Michelle Fredricson	F	71	Goldsmith Place
Mayuko Eckermann	F	86	Blake Street
Endri Clijsters	M	84	Woodgate Street
Olga Kasza	F	62	Story Street
Richard Ruiz	M	62	Opera Place
Augustin Lozano	M	19	Spinelli Place
Yana Al-Garni	F	60	Mendelssohn Street
Jan-Di Kazlou	F	89	Metcalf Street
Pierre-Alexis Valiyev	M	86	Cufflin Street
Jessica Steger	F	68	Coniston Road
Andres Bouramdane	M	41	Woodward Avenue
Elyes Viteckova	M	76	Ridlon Road
Denis Gonzalez	M	77	Cambria Street
Kyle Koala	M	16	Power House Street
Jukka Barros	M	62	Donwood Terrace
Laetitia Manuel	F	68	Germania Street
Anthony Machavariani	M	59	Morris Street
Lenka Minibaev	F	63	Latin Road
Augustine Oliveira	F	20	Kassul Park
Norayr Burton	M	84	Cranston Street
Thomas Gustafsson	M	79	K Street
Katerine Podlesnyy	F	87	Lee Burbank Highway
Yi Gretchichnikova	F	68	Oleary Way
Antoine Vidrio	M	77	Gifford Place
Lucy White	F	67	Flagg Street
David Yaroshchuk	M	28	Evergreen Street
Muhamad Horasan	M	50	Loyola Circle
Pavel Lepron	M	83	Channel Center Street
Zorana Kucukbay	F	26	Bellflower Street
Kim Jung	F	43	Atwood Road
Job Cole	M	60	Perkins Avenue
Yakhouba Garcia	M	55	Creighton Street
Marian Jager	F	71	Mcgreevey Way
Michelle-Lee Abril	F	36	Gold Star Road
Murray Nurudinov	M	68	Jackson Circle
Joanna Elhawary	F	77	Crockett Avenue
Mihail Flanigan	M	17	Boyden Street
Xiang Diaz	M	31	Durant Street
Allan Melgaard	M	31	North Washington Street
Gonzalo Nunes	M	46	Dunning Way
Pape Elaine	M	60	Ricker Terrace
Toni Aubameyang	M	49	Ernest Avenue
Jongwoo Bognar	M	81	Matignon Road
Lubov Begaj	F	17	Stoneholm Street
Brittany Brzozowicz	F	53	I Street
Elizabeth Smith	F	46	Albright Street
Tina Boidin	F	35	Avila Road
Adrienn Paratova	F	24	Veterans Of Foreign Wars Parkway
Li Watanabe	F	73	Necco Court
Diana Schuetze	F	39	Fall Road
Alejandro Velasquez	M	49	Grew Hill Road
Walton Souleymane	M	29	Rosemont Street
Gauthier Alimzhanov	M	23	Mindoro Street
Kelly Drexler	F	55	Marshall Street
Reid Demanov	M	32	Palace Road
Richard Kaniskina	M	61	Magdala Street
Natthanan Nakagawa	F	20	East Ninth Street
Gabriella Sarup	F	60	Eutaw Street
Emmanuel Hornsey	M	19	Gorham Street
Yuling Mueller	F	21	Brookdale Street
Maris Izmaylova	M	72	Averton Street
Marisa Rocamontes	F	76	Chatham Row
Kai Nascimento	M	70	Inman Court
Esmat Nicholson	F	74	Roxana Street
Victoria Monteiro	F	88	Lothian Road
Deni Iovu	M	69	Oliva Road
Leford Lapin	M	32	Chaucer Street
Yadira Marghiev	F	41	Queen Street
Fernando Bishop	M	65	Elgin Street
Slobodan Elaisa	M	67	Mountfort Street
Saheed Alhasan	M	51	Magazine Court
Lalonde Koski	M	77	Fordham Road
Roger Hocking	M	50	Robert Street
Viktor Santos	M	31	City Square
Hope Cseh	F	87	Dover Street
Dorothee Garderen	F	62	Lennoco Road
Maria Choi	F	17	Stanhope Street
Sara Birarelli	F	22	Jacqueline Road
Herve Kasa	M	82	Chickatawbut Street
Tassia Cejas	F	50	Fort Washington Place
Manuel Silva	M	33	Parker Hill Avenue
Bruno Ruban	M	86	Bent Street
Thomas Rondelez	M	73	Wheelock Avenue
Prisilla Nakamura	F	80	Stanton Street
Haikel Salman	M	62	Raleigh Street
Laurence Intanon	F	59	Woodbole Avenue
Jonas Calvert	M	49	Ruskin Road
Kristina Sireau	F	77	Seminary Street
Max Unamboowe	M	31	Glenarm Street
Angel Souza	M	55	Fairfield Street
Vicky Florez	F	58	Rushmore Street
Sander Piron	M	41	Belvidere Street
Martin Vanegas	M	38	Mount Pleasant Avenue
Imogen Thomsen	F	20	Storey Place
Petar Dominguez	M	64	Annafran Street
Juan Thomas	M	89	Bakersfield Street
Yun Kobori	F	82	Traill Street
Joyce Broersen	F	73	Cambridge Parkway
Lizzie Sheiko	F	46	Noble Court
Mechiel Schulz	M	23	Brahms Street
Maryam Allen	F	74	Harry Agganis Way
Charlotte Ranfagni	F	17	Lawton Street
Martyna Kirkbride	F	28	Homestead Street
Melania Fofanoff	F	68	Freeman Avenue
Takahiro Wagner	M	66	Commodore Terrace
Kianoush Tan	M	86	Melnea Cass Boulevard
Alexey Simonet	M	16	Land Boulevard
Hayley Fischer	F	66	Custom House Street
Nils Guzzetti	M	88	Alford Street
Polona Garderen	F	60	Cawfield Street
Khadzhimurat Wilkinson	M	23	Brooks Street
Kana Danois	F	46	Hartwell Street
Zicheng Bardis	M	30	Middle Street
Khairul Morningstar	M	17	Itasca Street
Hun-Min Soroka	M	56	Rustlewood Road
Manuel Davis	M	53	Meacham Road
Maksym Pawlowski	M	32	Bayswater Street
Konstadinos Sauer	M	65	Meyer Court
Sara Hore	F	22	Safford Street
Sam Tian	M	56	Webley Street
Donatien Dolassem	M	27	W Harrington Memorial Way
Keehee Rivers	M	19	Druid Street
Wenwen Pitchford	F	51	Nassau Street
Mira Moberg	F	49	Fullerton Street
Jade Jallouz	F	65	Malden Street
Rafal Saedeleer	M	88	Wise Street
Eelco Aramburu	M	81	New Frontage Road North
Jennifer Mulabegovic	F	77	Lilac Court
Luana Li	F	86	Bantry Way
Myung McCafferty	M	36	Smart Street
Zamandosi Chuang	F	88	Yorktown Street
Thilo Figueroa	M	45	Gould Street
Neymar Kaczor	M	68	San Juan Street
Rebecca Castaneda	F	73	Conry Crescent Street
Rima Sommer	F	46	Chappie Street
Yavor Gonzalez	M	24	Liszt Street
Vera Gerrand	F	88	Favre Street
Jens Seierskilde	M	90	Pender Street
Ade Blouin	M	31	Pinefield Lane
Erasmus Flood	M	61	Felton Street
Ivo Bagdonas	M	62	Joslin Road
Song-Chol Kim	M	60	Dalin Place
Omar Atkinson	M	79	Alford Street
Jarmila Hallgrimsson	F	43	Seaverns Avenue
Krista Dai	F	41	Proctor Street
James Brooks	M	55	Ackley Place
Stsiapan Kaun	M	89	Glenley Terrace
Anja Jang	F	75	Melcher Street
Annika Kim	F	18	Quarley Road
Hao Kostelecky	M	71	Hubbard Park Road
Gloria Martinez	F	31	Cambridgepark Drive
Zachary Schelin	M	89	Lomasney Way
Mulualem Rodriguez	M	68	Fair Oaks Street
Rafal Sidorov	M	48	Clarendon Avenue
Gauthier Burns	M	18	Thurston Street
Reinaldo Mutlu	M	73	Woodledge Street
Daniel Lim	M	59	Lafield Street
Mona Colupaev	F	24	Havre Street
Nur Beisel	F	74	Nightingale Street
Yihua Grunsven	F	43	Willard Street Court
Yuko Gennaro	F	26	Raven Street
Tian Abdvali	M	76	Parklawn Road
Lisbeth Alptekin	F	81	Woodside Avenue
Yvonne Bale	F	39	W Harrington Memorial Way
Virginie Monteiro	F	63	Munroe Street
David Jr	M	22	Brother Joseph A Heeran Way
Kevin Dawidowicz	M	77	Willard Street Court
Xiayan Harden	M	50	Judge Street
Byungchul Lee	M	76	Macdonald Street
Christofer Sokolova	M	29	Emmonsdale Road
Jitka Tranter	F	58	Sherborn Street
Triyaningsih Elkawiseh	F	68	Wilcox Road
Muhamad Lascar	M	66	Ramsdell Avenue
Luis Bos	M	61	Ardent Street
Florian Sugawara	M	46	Jennett Avenue
Virginie Zhang	F	19	Josephine Street
Amy Kim	F	33	Drapers Lane
Satoko Wang	F	27	Rainier Road
Nurmakhan Hoskins	M	71	Legion Place
Ben Welsh	M	45	Rosaria Street
Dina Hwang	F	88	Ashwood Terrace
Ahmed Docherty	M	33	Willowdean Avenue
Marleen Rodrigues	F	16	Chapel Road
Nurul Amanova	F	32	Gilmer Street
Alexandre Sawers	M	71	Carroll Street
Marin Absalon	M	25	Potter Park
Charles Cadee	M	65	Coolidge Hill Road
Amine Lin	M	70	Farragut Road
Sanja Kusuro	F	69	Henry Street
Jun Zhudina	F	77	Woodville Park
Jonas Vlcek	M	30	Fountain Street
Egor Culley	M	90	Maybury Street
Josefin Crawshay	F	55	Dwight Street
Emma Wei	F	90	Durland Street
Andrei Delattre-Demory	M	24	Letterfine Terrace
Jose Chen	M	51	Pleasant Valley Circle
Yannick Remarenco	M	72	Slocum Road
Farida Sitic	F	81	Raleigh Street
Sara Walker	F	28	McTernan Street
Tyler Marennikova	M	65	Cumston Place
Julian Mehmedi	M	81	Starr Lane
Kristy Zhu	F	36	Sleeper Street
Rikke Ayeko	F	20	Ashburton Place
Paola Tai	F	29	Edgewater Drive
Nikolina Khuraskina	F	18	Dover Street
Yury Mensah-Bonsu	M	50	Salisbury Park
Ida Robinson	F	77	Electric Avenue
Claudia Nieto	F	56	Meadow Road
Rebecca Teply	F	42	Clarence Street
Lene Zargari	F	30	Melvinside Terrace
Rimantas Luca	M	72	New Cypher Street
Przemyslaw Liang	M	29	Ukraine Way
Alison Potro	F	59	Meshaka Street
Sue Chouhal	F	83	Brookline Avenue
Jan Gramkov	M	51	James Shea Circle
Ignisious Hijgenaar	M	43	Barlow Street
Darae Charlos	F	47	Heath Street
Timothy Francisca	M	28	Alewife T Station Access Road
Artem Napoleon	M	85	Stevens Court
Tatyana Wang	F	54	Walworth Street
Jean Svechnikova	M	76	Cygnet Street
Roderick Atari	M	76	Dorrance Street
Anthony Dahlgren	M	27	Nantasket Avenue
Pamela Fuchs	F	35	Ardee Street
Oleksiy Ferrer	M	70	Norris Road
Maria Figlioli	F	43	Windsor Road
Marie-Louise Hosking	F	17	Shaw Street
Radu Colley	M	47	Rainier Road
Anthony Gerrand	M	89	Boardman Street
James Padilla	M	27	Porter Circle
Saskia Rosolova	F	39	Burbank Street
Fortunato Asgari	M	72	Pleasant Hill Avenue
Helema Verga	F	35	C Street
Ling Kromowidjojo	F	74	Elba Terrace
Stacey Frolov	F	30	Albert Street
Kara Vougiouka	M	36	Atherton Avenue
Michelle Boonen	F	50	Potomac Street
Ekaterina Thibus	F	63	Saville Street
Sergey Barachet	M	40	Tremlett Street
Cory Munoz	M	70	Ivory Street
Orlin Bondarenko	M	26	Overlook Road
Mannad Khitraya	M	50	Guild Street
Mareme Mihelic	F	51	Harrington Avenue
Clara Fuentes	F	23	Revere Street
Meghan Sato	F	22	Claymont Terrace
Nada Domingos	F	36	Payson Avenue
Egidio Kleiza	M	89	Abby Road
Adnane Wang	M	56	Moss Hill Road
Marjo Al-Mashhadani	F	38	Mckinley Square
Donatien Otoshi	M	82	Lovell Street
Muller Nikcevic	M	52	Parker Hill Avenue
Simon Rigaudo	M	24	Midvale Road
Kimberley Colhado	F	50	Storrow Drive
Emanuele Hussein	M	18	Adirondack Place
Victoria Ndong	F	55	Fowler Street
Aleksandr Inthavong	M	18	Barclay Road
Gonzalo Pacheco	M	78	Mann Street
Andrei Masna	M	58	Stoughton Street
Micheen Bianco	F	23	Victor Street
Bernard Yip	M	34	Bullard Street
Ventsislav Niyazbekov	M	33	Sunnybank Road
Annika Wang	F	46	Saranac Street
Gesa Su	F	24	Bloomington Street
Alison Hayytbaeva	M	35	Locksley Street
Ryan Wang	M	50	Victory Road
Daisuke Saranovic	M	78	Cornauba Street
Stephanie Sofyan	F	39	Palermo Street
Marta Loza	F	38	Cross Road
Dmytro Song	M	39	Ramsdell Avenue
Taehee Bondaruk	M	79	Hichborn Street
Shuichi Remarenco	M	72	Southern Avenue
Laura Helgesson	F	50	Burns Court
Vlado Gu	M	61	Colorado Street
Daeyoong Rodrigues	M	40	Highcrest Road
Karsten Thompson	M	49	Bradford Circle
Aina Gavrilovich	F	64	Jennett Avenue
Aya Rakoczy	F	80	Shandon Road
Mirna Seck	F	19	Monterey Avenue
Soulmaz Zolnerovics	F	32	Englewood Avenue
Nooa Jonge	M	17	Chilcott Place
Bastian Beadsworth	M	60	Burgess Street
Martin Houvenaghel	M	65	Noah Street
Britany Oatley	F	57	Gibson Street
Pui Na	F	21	Design Center Place
Jermaine Qin	M	29	Benton Street
Andres Shi	M	89	Joslin Road
Lucy Nakaya	F	50	Hooper Place
Francois Sedoc	M	71	Prairie Street
Silas Voronkov	M	28	Greenmount Place
Eric Gogaev	M	61	Esten Street
Jonathan Gudmundsson	M	52	Greenough Avenue
Seen Dehesa	F	35	Sharp Street
Thomas Magi	M	16	Neponset Valley Parkway
Emma Alphen	F	49	Claxton Street
Hyun Persson	M	55	Bradlee Court
Line Naylor	F	85	Pierce Avenue
Abouhalima Uptagrafft	M	29	Thane Street
Leandro Schuetze	M	36	Shawmut Avenue
Clemens Mulabegovic	M	66	Waldo Terrace
Morgan Najah	M	49	Cufflin Street
Liam Maley	M	73	Charlestown Avenue
Kasper Addy	M	86	Faneuil Street
Dorian Sankuru	F	32	Grew Avenue
Christopher Erichsen	M	57	Wiltshire Road
Annalie Ekame	F	73	Larchwood Drive
Trixi Niwa	F	23	Old Road
Javier Branza	M	82	Vallaro Road
Matteo Verschuren	M	66	Burt Street
Andreas Paonessa	M	69	Ardmore Road
Alan Thiney	M	55	Degautier Way
Ashley Tymoshchenko	F	80	Byrd Avenue
Selim Tregaro	M	80	Zamora Court
Maximilian Sedoykina	M	78	Mansen Court
Noraseela Podrazil	F	81	Gustin Street
Paulo Seric	M	38	Bellevue Avenue
Matteo Goncharova	M	48	Southampton Street
Gergo Faulkner	M	77	Gordon Avenue
Vera Rickard	F	34	Mishawum Street
Hector Costagrande	M	57	Mckinley Square
Stephanie Adlington	F	28	Robeson Street
Wai Mazic	F	77	Granfield Avenue
Jurgen Granollers	M	40	Upland Avenue
Dongwon Rodriguez	M	40	Traveler Street
David Svarc	M	55	Tafthill Park
Gloria Tayler	F	58	Wollaston Terrace
Teun Tancock	M	76	Derry Road
Oliba Bosetti	F	21	Locke Street
Alyssa Fouhy	F	56	Wright Street
Jerome Amoros	M	61	Sanger Street
Raul Hoshina	M	70	Marion Place
Huajun Gbagbeke	F	74	Thetford Avenue
Jong Borysik	F	68	Viking Street
Roland Scott	M	71	Birmingham Parkway
Ian Stepanova	M	45	Messinger Street
Rikke Jackson	F	37	McTernan Street
James Chetcuti	M	39	Anawan Avenue
Beatriz Smock	F	72	Ridgemont Street
Hedvig Crain	F	66	Oakview Avenue
Natalia Beresnyeva	F	32	Al Zwiercan Way
Daniel Saleh	M	23	Sherman Road
Saskia Pliev	F	59	Cheriton Road
Luis Klose	M	64	Field Street
Mayara Trinquier	F	71	Grampian Way
Xiaojun Hachlaf	M	73	Eric Street
Bruna Gall	F	40	Holmes Street
Emin Sterba	M	44	Elmhurst Street
Zoe Castillo	F	32	Josephine Street
Endurance Emmanuel	F	78	Constitution Road
William Vicaut	M	47	Southampton Street
Vincent Lawrence	M	55	Tuttle Street
Lei Vican	F	56	Magee Street
Matthew Rosolova	M	50	Van Winkle Street
Peter Prinsloo	M	53	Oak Place
Omolara Lopez	F	89	Arborcrest Terrace
Carrie Manson	F	22	Wendell Place
Arnie Flaque	M	73	Burgess Street
Nestor Seric	M	76	Brooks Street
Murilo Rohart	M	27	Wheeler Street
Roline Rasmussen	F	57	Tai Tung Street
Katarzyna Norgaard	F	74	Huntoon Street
Jinjie Meeuw	F	16	High Road
Liangliang Miller	M	31	Wellsmere Road
Ihar Radwanska	M	69	Laval Street
Amaka Mathlouthi	F	41	Duncklee Road
Rene Marques	M	76	Agnes Avenue
Yevgeniy Ghiban	M	49	Bedford Street
Alex Russell	M	54	Factory Street
Dathan Ziadi	M	44	Traymore Street
Hasan Bryukhankov	M	58	Cheney Street
Bill Turner	M	68	Wiggin Street
Yu Sakaguchi	F	80	Rozella Street
Ryoko Jesien	F	73	P Street
Rodrigo Burke	M	56	Sunset Hill Road
Judith Plotyczer	F	44	Agnes Avenue
Kayla Kim	F	86	Porter Circle
Fredy Melis	M	25	Fox Point Road
Lenise Jaquet	F	85	Cedrus Avenue
Jennifer Yu	F	66	Parkway Road
Elizabeth Cheon	F	64	Beale Street
Nikolaos Bauer	M	54	Rutledge Street
Aleksei Ruiz	M	84	Hallam Street
Janet Ganeev	F	55	Mckinley Square
Lina Tjoka	F	31	Healey Street
Laura Khokhlova	F	33	Livingstone Street
Zied Rumjancevs	M	54	Franklin Park Service Road
Sarah Male	F	82	Marcy Road
Phillipp Absalon	M	45	New Minton Street
Joao Dovgodko	M	32	Newbury Street
Agnese Bartakova	F	68	Norwell Street
Hanna Wraae	F	59	Grozier Road
Peter Lasko	M	61	Morrow Road
Hugues Kim	M	41	Hampstead Lane
Nenad Blerk	M	43	Scottfield Road
Thiago Malave	M	56	Clermont Street
Jo-Wilfried Schornberg	M	89	Driscoll Drive
Maurine Peters	F	54	Gwinnett Street
Jong Hojka	M	51	Deering Road
Jackelina Gadisov	F	51	Prescott Place
Grzegorz Zarkua	M	68	Slocum Road
George Fuente	M	43	Bradfield Avenue
Oribe Bidaoui	M	28	Deacon Street
Hesham Hunter	M	41	Rockwood Street
Slobodan White	M	29	Dudley Court
Aya Levina	F	48	Topliff Street
Marcel Petersen	M	48	Prince Street
Eva Ji	F	47	Blakemore Street
Shiho Berkel	F	45	Ardee Street
Edward Kadelbach	M	77	Etna Street
Tamas Guo	M	18	Fessenden Street
Lidia Bird	F	64	Harlem Street
Olivia Gascon	F	75	Grafton Street
Anderson Schenk	M	54	Capen Place
Nicholas Ihle	M	56	Schiller Road
Apostolos Sharp	M	76	Homewood Road
Jihane Rulon	F	29	Hopestill Street
Ahmed Borodavko	M	80	Delford Street
Pawel Strlek	M	80	Sheridan Street
Jacqueline Sauvage	F	16	Port Lane
Ilka Macias	F	62	Dungarven Road
Nastassia Jorge	F	66	Cohasset Street
Natasha Birgmark	F	48	Bradbury Street
Ivan Grandon	M	26	Terrace Place
Norman Chen	M	35	Sellers Street
Kenenisa Tomasevic	M	48	Southern Avenue
Ryan Bouaasayriya	M	27	Weybosset Street
Lisa Ledecky	F	27	Monterey Avenue
Risa Synoradzka	F	45	Arsenal Street
Maria Gay	F	24	Cambridgeside Place
Marlene Nicholson	F	77	Wilbur Street
Sung Dyadchuk	M	82	Bent Street
Guzel Vicente	F	68	Romsey Street
Tiberiu Montano	M	53	Colliston Road
Urszula Heffernan	F	30	Sturbridge Street
Ashley Scott	M	89	Delore Circle
Will Mehmedovic	M	67	Degautier Way
Carolina Macias	F	73	Wallace Court
Monika Hwang	F	50	Stanbro Street
Sun Brink	F	35	Hillock Street
Carlos Yakimenko	M	29	Mansen Court
Dragana Yonemoto	F	35	Saint Margaret Street
Taehwan Tulo	M	69	Marion Place
Daniela Gavnholt	F	89	White Oak Road
Kim Kable	F	87	Andrews Place
Koji Miyama	M	39	Wood Avenue
Sarolta Coughlin	F	42	Fullerton Street
Simon Stepanyuk	M	63	Somerville Avenue
Jacob Harris	M	51	Cardinal Medeiros Avenue
Ana Dukic	F	74	Reservation Road
Dorian Taylor	M	22	Bryant Road
Leonardo Ghebresilasie	M	68	Trident Street
Gabrio Dowabobo	M	84	Parkside Drive
Niklas Donckers	M	18	Howard Avenue
Mohamed Silva	M	17	Chamblet Street
Annika Stanning	F	74	Eugenia Road
Antony Williams	M	85	Hutchings Street
Irene Krueger	F	72	Ivory Street
Alejandro Collins	M	33	Olney Street
Eslam Kaifuchi	M	80	Henderson Avenue
Denis Nasirshelal	M	79	Burard Street
Daniel Liu	M	83	Crown Point Drive
Anne Grishaeva	F	45	Hyde Park Avenue
Arnor Grozdeva	M	63	Chelmsford Street
Hamza Tomecek	M	36	Woodland Place
Bostjan Kasold	M	52	Claxton Street
Jack Garcia	M	30	Lothrop Street
Oscar Sanchez	M	82	Derne Street
Jinzhe Aubameyang	M	40	Silva Place
Natalia Akwu	F	25	Shattuck Street
Shaunae Stoney	F	63	Laval Street
Pieter-Jan Huang	M	31	Harvest Street
Lei Fuente	M	25	Eagle Square
Camille Giglmayr	M	52	Linnaean Street
Nicholas Kudryashov	M	45	Kinross Road
Birhan Evans	M	81	Grafton Street
Agnes Vasina	F	65	Trevore Street
Natsumi Pohlak	F	55	William Day Boulevard
Oleksiy Zhao	M	90	Vandine Street
Janin Aramburu	F	54	Bronx Road
Peter Siuzeva	M	32	Elizabeth Street
Dipna Hammon	F	39	Calumet Street
Casey Cullen	F	70	Highland Avenue
Ibrahim Oie	M	40	Ramsey Street
Cian Purnell	M	31	Lodgehill Road
Reza Hoff	M	46	Conrad Street
Yating Matas	F	77	Charter Street
Deni Yao	M	65	Rockway Street
Sergi Mohr	M	31	Dromey Street
Kim Doder	F	18	Trask Street
Ekaterina Cabral	F	18	Old Road
Sutiya Kida	F	65	Hollywood Road
Michael Zabala-Goetschel	M	70	Sherrin Street
Lena Hagara	F	22	Taunton Avenue
Ludivine Chetcuti	F	79	Brinsley Street
Katarzyna Gelana	F	47	Grahm Street
Roba Monsegur	M	87	Woodmont Street
Moritz Dibaba	M	16	Parklawn Road
Deniz Kowalska	M	37	Cawfield Street
Olga Lobuzov	F	68	Rich Hood Avenue
Yunlei Xu	F	88	Alleyne Street
Facinet Ratna	M	53	Woodstock Avenue
Blair Stratton	M	17	Dunwell Street
Lars Mcclatchey	M	34	Piedmont Street
Scott Klein	M	44	Terrace Place
Huajun Oates	F	37	Hobart Street
Mechiel Maric	M	72	Prospect Avenue
Claudia Kavanagh	F	51	Dodge Road
Ganna Podhrasky	F	34	Spalding Street
Rhys Faber	M	53	Jeshurun Street
Noemi Chacha	F	53	Kenilworth Street
Gulfiya Cornelissen	F	77	Allston Court
Aaron Cho	M	23	Cricket Lane
Isil Gonzalez	F	82	Charlame Place
le Toksoy	M	28	Potter Park
Weiwei Kiprotich	F	20	Common Street
Karin Egwero	F	70	Saybrook Street
Gemma Wang	F	25	Hackensack Circle
Jake Claver	M	25	Jennett Avenue
Nina Mascinskas	F	57	Nay Street
Nam Baga	M	69	Alpha Road
Nick Rogers	M	68	Royal Avenue
Caroline Denayer	F	65	Risley Road
Corinna Bakale	F	80	Muller Avenue
Spas Traore	M	17	Williston Road
Konstantinos Milanovic-Litre	M	72	Presentation Road
Romano Mostafa	M	42	Farrington Avenue
Dirkie Soares	F	36	Ransom Road
Cameron Allepuz	M	42	Northern Avenue
Feta Juhasz	F	35	Sturbridge Street
Elizabeth Batki	F	51	Inwood Street
Ahreum Sum	F	61	Millmont Street
Alethea Gibbons	F	46	Goodale Road
Ivan Gao	M	49	Lothian Road
Sergey Kain	M	30	Jacob Street
Megan Angelov	F	71	Spruce Avenue
Jinyan Binobagira	F	85	Bremen Street
Maja Balykina	F	76	Archdale Road
Aleksandr Kim	M	30	Rogers Street
Susana Neymour	F	34	Lorraine Street
Sayaka Kovacevic	F	46	Druid Street
Rodrigo Surgeloose	M	79	Eastbourne Street
Yuichi Burgh	M	43	Wilkinson Park
Bjorn Couch	M	29	Hillview Avenue
Steffen Henriques	M	59	Brandywyne Drive
Sarah Dovgun	F	70	Linnet Street
Richard Hybois	M	68	Lowell Street
Elisabeth Amertil	F	73	Pickering Avenue
Quentin Larionov	M	36	Gallivan Boulevard
Sena Pietrus	F	40	Corwin Street
Pal Amorim	M	40	Albion Place
Rajiv Fogarty	M	57	Pierpont Road
Kim Mahran	M	72	Pemberton Court
Angel Cash	F	63	Cottrell Street
Tatyana Flognman	F	25	Clifford Street
Barna Feddal	M	58	Adams Street
Eusebio Wallace	M	71	Valley Road
Arnaldo Shulika	M	87	Middlesex Street
Aretha Hatton	F	69	Atherstone Street
Pierre-Alexis Steinegger	M	41	Belmore Terrace
Gilles Zhang	M	43	Hewes Street
Yuki Hayashi	F	24	Oakman Street
David Lashin	M	42	Hawes Street
Sylwia Yang	F	29	Rena Street
Fabio Simic	M	72	Edmunds Street
Evi Fang	F	60	Nichols Place
Artem Tops-Alexander	M	42	Clayton Street
Luis Gascon	M	39	Dighton Street
Pau Moreira	M	32	Queensberry Street
Vaclav Mustapa	M	47	Gifford Place
Virgil Neny	M	33	Hollywood Road
Mohammed Popp	M	43	Vancouver Street
William Bindrich	M	42	Talbot Avenue
Daniel Loyden	M	83	Emmett Place
Nina Krause	F	25	Beachview Road
Yuliya Gomes	F	41	Friend Street
David Schuh	M	80	Elwell Road
Carlos Dyatchin	M	30	Bicknell Street
Kanae Uriarte	F	81	Ginita Street
Louise Jin	F	51	Dietz Court
Dariya Kalentieva	F	44	Burrell Street
Vicente Shemarov	M	57	Leniston Street
Sardar Vuckovic	M	72	Louisburg Square
Kate Scheuber	F	55	Hollywood Road
Lissa Drmic	F	60	Astoria Street
Dorothy Reckermann	F	80	Prairie Street
Mujinga Peterson	F	77	Bradbury Street
Lena Bithell	F	55	Robinson Street
Ingrid Papachristos	F	30	Presley Road
Vered Barrondo	F	38	Armandine Street
Laura Fahden	F	29	Alicia Road
Yuliya Cuesta	F	38	Willers Street
Andreas Pozzi	M	86	Coniston Road
Alexa Loch	F	85	Foundry Street
Irina Camara	F	58	Wilna Court
Melissa Guell	F	53	Van Brunt Street
Thomas Kuznetsov	M	89	Benton Street
Pascal Davaasukh	M	70	Montcalm Avenue
Petar Bauwens	M	31	Delmont Street
Alan Gaspic	M	63	Shaw Street
Thi Li	F	85	Redwood Street
Milena Hall	F	42	Bellamy Street
Anna Beaubrun	F	55	Kassul Park
Maik Komazawa	M	38	Marginal Road
Elena Modenesi	F	37	Arundel Street
Aleksandr Rutherford	M	75	Elmont Street
Zargo Dehesa	M	25	Clevemont Avenue
Bryan Razarenova	M	87	Power House Street
Mona Taibi	F	25	Locke Street
Rita Pena	F	16	Spring Valley Road
Roman Ledaki	M	25	Moultrie Street
Shaune Hurskainen	M	48	Cunard Street
Jarrod Kovalenko	M	39	Ainsley Street
Gyujin Scanlan	M	50	Violante Street
Fateh Kovalev	M	82	New Park Avenue
Elena Michan	F	37	Shawsheen Road
Radoslaw Robles	M	42	Alkyris Road
Hang Slimane	F	81	Westville Street
Yayoi Buckman	F	42	Rosecliff Street
Vladislav Abalo	M	78	Chapel Road
Simon Alphen	M	33	Glenn Road
Konstadinos Justus	M	23	Hinckley Street
Paula Tom	F	70	Saint Richard Street
Qiang Hradecka	M	70	Westbrook Street
Jennifer Athanasiadis	F	81	Bickford Avenue
Elena Costa	F	20	Fair Oaks Street
Aleksandra Gordon	F	75	Yard Way
Hyobi Magnini	F	56	Ardee Street
Ian Rhodes	M	71	K Street Place
Tsagaanbaatar Kjellberg	M	77	Atkinson Street
Catriona Mottram	F	38	Pasadena Road
Louise Fernandez	F	84	Sanger Street
Jonathan Cornelius	M	31	Monmouth Street
Matt Waite	M	24	Alpine Street
Tomasz Lanzone	M	86	Necco Court
Dirk Steuer	M	43	Bagnal Street
Lukasz Dudas	M	58	Birchcroft Road
Virginie Medina	F	27	Waldorf Street
Andriy Hrachov	M	16	Bantry Way
Ziwei Braas	F	70	Lyne Road
Hector Moutoussamy	M	66	Muller Avenue
Xiaodong Dulko	F	69	Homewood Road
Ivan Radu	M	29	Clinton Place
Christopher Sadauskas	M	86	Lancaster Street
Lizeth Coertzen	F	58	Greenock Street
Alexander Heffernan	M	43	Oleander Street